BANDANA LEVEL
----------------------------------------
File created with Bandana level editor.
To play the level, put it into the 'userlevels'
subdirectory. To edit it, place this file into
the 'mylevels' directory.
Dimensions: 33,21

Author: micha
Description:

endDescription

Background:
--------------------------------
--------------------------------
--------------------------------
--------------------------------
--------------------------------
--------------------------------
--------------------------------
--------------------------------
--------------------------------
--------------------------------
--------------------------------
--------------------------------
--------------------------------
--------------------------------
--------------------------------
--------------------------------
--------------------------------
--------------------------------
--------------------------------
--------------------------------
endBackground

Ground:
11111111cccccccccccccccc11111111
11111111c------cc------c11111111
11111111c------cc------c11111111
11111111c------cc------c11111111
11111111c-1----cc----1-c11111111
11111111c-1----cc----1-c11111111
11111111c-1----cc----1-c11111111
11111111c-c----cc----c-c11111111
11111111c-cccccccccccc-c11111111
1cccccccc--c--------c--cccccccc1
1c------c--c--------c--c------c1
1c------c--c--------c--c------c1
1c---------c---11---c---------c1
1c-11------c---11---c------11-c1
1c-11ccccccc---cc---ccccccc11-c1
1c-------------cc-------------c1
1c-------------cc-------------c1
1cccccccccccccccccccccccccccccc1
11111111111111111111111111111111
11111111111111111111111111111111
endGround

BgObjects:
endBgObjects

Objects:
Obj:Player
	x:13
	y:7
	p:canHook=true
	p:canParachute=true
	p:canTeleport=true
	p:canWalljump=true
endObj
Obj:Exit
	x:18
	y:7
endObj
endObjects

