BANDANA LEVEL
----------------------------------------
File created with Bandana level editor.
To play the level, put it into the 'userlevels'
subdirectory. To edit it, place this file into
the 'mylevels' directory.
MapFileVersion:1
Dimensions: 67,21

Author: micha
Description:

endDescription

Background:
------------------------------------------------------------------
------------------------------------------------------------------
------------------------------------------------------------------
------------------------------------------------------------------
------------------------------------------------------------------
------------------------------------------------------------------
------------------------------------------------------------------
------------------------------------------------------------------
------------------------------------------------------------------
------------------------------------------------------------------
------------------------------------------------------------------
------------------------------------------------------------------
------------------------------------------------------------------
------------------------------------------------------------------
------------------------------------------------------------------
------------------------------------------------------------------
------------------------------------------------------------------
------------------------------------------------------------------
------------------------------------------------------------------
------------------------------------------------------------------
endBackground

Ground:
----------------------------oooooooooooooooooooooooooooooooooooooo
----------------------------o-----------------------2--------ooooo
----------------------------o----oo-oooooooo--------2---------oooo
----------------------------o--------------oooo-----2-----------oo
----------------------------ooooooooo---------o-----2-----------oo
------------------------------------o---------o-----2-ooooo------o
----------2-------------------------ooooooo---o-----2--oo--------o
----------2-------------------------2---------o-----2------------o
----------2-------------2---2-------2---------o-----2------------o
----------2-------------2---2----222222-------o-----2------------o
----------222222222-----2---2---------2-------o-----2------------o
------------------------2---2---------2-------o-----2-------------
------------------------2---2---------2-------2-----2-------------
------------------------2---2---------2-------2-----2-------------
---------------2--------2---2-----------------2-------------------
---------------2--------2---2-----------------2-------------------
--ooo-------------------2---2-----------------2-------------------
------------------------2---2-----------------2-------------------
------------------------------------------------------------------
222222222222222222222222222222222222222222222222222222222222222---
endGround

BgObjects:
endBgObjects

Objects:
Obj:Walker
	x:1
	y:18
	p:type=false
	p:direction=1
	p:strength=23
endObj
Obj:Walker
	x:4
	y:18
	p:type=false
	p:direction=1
	p:strength=16
endObj
Obj:Player
	x:3
	y:15
	p:canHook=true
	p:canParachute=true
	p:canTeleport=true
	p:canWalljump=true
endObj
Obj:Exit
	x:56
	y:4
endObj
Obj:Rotator
	x:35
	y:2
	p:rOuter=4
	p:rInner=1
	p:nArms=2
	p:angle=0
	p:speed=1
endObj
endObjects

