BANDANA LEVEL
----------------------------------------
File created with Bandana level editor.
To play the level, put it into the 'userlevels'
subdirectory. To edit it, place this file into
the 'mylevels' directory.
MapFileVersion:1
Dimensions: 67,21

Author: micha
Description:

endDescription

Background:
------------------------------------------------------------------
------------------------------------------------------------------
------------------------------------------------------------------
------------------------------------------------------------------
------------------------------------------------------------------
------------------------------------------------------------------
------------------------------------------------------------------
------------------------------------------------------------------
------------------------------------------------------------------
------------------------------------------------------------------
------------------------------------------------------------------
------------------------------------------------------------------
------------------------------------------------------------------
------------------------------------------------------------------
------------------------------------------------------------------
------------------------------------------------------------------
------------------------------------------------------------------
------------------------------------------------------------------
------------------------------------------------------------------
------------------------------------------------------------------
endBackground

Ground:
----------------------------rrrrrrrrrrrrrrrrrrrrrrrrrrrrrrrrrrrrrr
----------------------------r-----------------------3--------rrrrr
----------------------------r--ooo-rrrrrrrrr--------3---------rrrr
----------------------------r--------------rrrr-----3-----------rr
----------------------------rrrrrr------------r-----3-----------rr
---------------------------------r------------r-----3-rrrrr------r
----------3----------------------rrrrrrrrr----r-----3--rr--------r
----------3----------------------3------------r-----3------------r
----------3-------------3---3----3------------r-----3------------r
----------3-------------3---3----333333-------r-----3------------r
----------333333333-----3---3---------3-------r-----3------------r
------------------------3---3---------3-------r-------------------
------------------------3---3---------3-------3-------------------
------------------------3---3---------3-------3-------------------
---------------3--------3---3-----------------3-------------------
---------------3--------3---3-----------------3-------------------
--rrr-------------------3---3-----------------3-------------------
------------------------3---3-----------------3-------------------
------------------------------------------------------------------
333333333333333333333333333333333333333333333333333333333333333---
endGround

BgObjects:
endBgObjects

Objects:
Obj:Walker
	x:1
	y:18
	p:type=bouncy
	p:direction=1
	p:strength=23
endObj
Obj:Walker
	x:4
	y:18
	p:type=bouncy
	p:direction=1
	p:strength=16
endObj
Obj:Player
	x:3
	y:15
	p:bandana=green
endObj
Obj:Exit
	x:56
	y:4
endObj
Obj:Rotator
	x:34
	y:2
	p:rOuter=4
	p:rInner=1
	p:nArms=1
	p:angle=3.1415926535898
	p:speed=1
endObj
Obj:ParallaxConfig
	x:20
	y:19
	p:location=3
	p:color=blue
endObj
endObjects

