mapSize(36, 20)
start{x=4,y=15}
loadBG{
  {0,0,0,0,0,0,0,0,0,0,0,0,0,0,0,0,0,0,0,0},
  {0,0,0,0,0,0,0,0,0,0,0,0,0,0,0,0,0,0,0,0},
  {0,0,0,0,0,0,0,0,0,0,0,0,0,0,0,0,0,0,0,0},
  {0,0,0,0,0,0,0,0,0,0,0,0,0,0,0,0,0,0,0,0},
  {0,0,0,0,0,0,0,0,0,0,0,0,0,0,0,0,0,0,0,0},
  {0,0,0,0,0,0,0,0,0,0,0,0,0,0,0,0,0,0,0,0},
  {0,0,0,0,0,0,0,0,0,0,0,0,0,0,0,0,0,0,0,0},
  {0,0,0,0,0,0,0,0,0,0,0,0,0,0,0,0,0,0,0,0},
  {0,0,0,0,0,0,0,0,0,0,0,0,0,0,0,0,0,0,0,0},
  {0,0,0,0,0,0,0,0,0,0,0,0,0,0,0,0,0,0,0,0},
  {0,0,0,0,0,0,0,0,0,0,0,0,0,0,0,0,0,0,0,0},
  {0,0,0,0,0,0,0,0,0,0,26,0,0,50,0,0,0,0,0,0},
  {0,0,0,0,0,0,0,0,0,0,27,35,43,51,0,0,0,0,0,0},
  {0,0,0,0,0,0,0,0,0,0,28,36,44,52,0,0,0,0,0,0},
  {0,0,0,0,0,0,0,0,0,0,29,37,45,53,0,0,0,0,0,0},
  {0,0,0,0,0,0,0,0,0,0,30,38,46,54,0,0,0,0,0,0},
  {0,0,0,0,0,0,0,0,0,0,31,39,47,55,0,0,0,0,0,0},
  {0,0,0,0,0,0,0,0,0,0,32,0,0,0,0,0,0,0,0,0},
  {0,0,0,0,0,0,0,0,0,0,0,0,0,0,0,0,0,0,0,0},
  {0,0,0,0,0,0,0,0,0,9,9,9,9,9,0,0,0,0,0,0},
  {0,0,10,10,10,10,10,10,10,10,10,10,10,10,0,0,0,0,0,0},
  {0,0,10,10,10,10,10,10,10,10,10,10,10,10,0,0,0,0,0,0},
  {0,0,10,10,6,10,10,10,10,10,10,10,10,10,10,10,10,10,0,0},
  {0,0,10,10,10,10,10,10,10,10,10,10,10,10,10,10,10,10,0,0},
  {0,0,10,10,10,10,10,10,10,10,10,10,10,10,10,10,10,10,0,0},
  {0,0,10,10,6,10,10,10,10,10,10,10,10,10,10,10,10,10,0,0},
  {0,0,10,10,10,10,10,10,10,10,10,10,10,10,10,10,10,10,0,0},
  {0,0,10,10,89,10,10,10,10,10,10,10,97,10,10,10,10,10,0,0},
  {0,0,10,10,10,10,10,10,10,10,10,10,10,10,10,10,10,10,0,0},
  {0,0,0,10,74,82,10,10,10,10,10,10,10,10,10,10,10,10,0,0},
  {0,0,0,0,11,11,11,0,0,0,0,0,0,0,0,0,0,0,0,0},
  {0,0,0,0,0,0,0,0,0,0,0,0,0,0,0,0,0,0,0,0},
  {0,0,0,0,0,0,0,0,0,0,0,0,0,0,0,0,0,0,0,0},
  {0,0,0,0,0,0,0,0,0,0,0,0,0,0,0,0,0,0,0,0},
  {0,0,0,0,0,0,0,0,0,0,0,0,0,0,0,0,0,0,0,0},
  {0,0,0,0,0,0,0,0,0,0,0,0,0,0,0,0,0,0,0,0}
}
loadFG{
  {0,0,0,0,0,0,0,0,0,0,0,0,0,0,0,0,0,0,0,0},
  {0,0,0,0,0,0,0,0,0,0,0,0,0,0,0,0,0,0,0,0},
  {0,0,0,0,0,0,0,0,0,0,0,0,0,0,0,0,0,0,0,0},
  {0,0,0,0,0,0,0,0,0,0,0,0,0,0,0,0,0,0,0,0},
  {0,0,0,0,0,0,0,0,0,0,0,0,0,0,0,0,0,0,0,0},
  {0,0,0,0,0,0,0,0,0,0,0,0,0,0,0,0,0,0,0,0},
  {0,0,0,0,0,0,0,0,0,0,0,0,0,0,0,0,0,0,0,0},
  {0,0,0,0,0,0,0,0,0,0,0,0,0,0,0,0,0,0,0,0},
  {0,0,0,0,0,0,0,0,0,0,0,0,0,0,0,0,0,0,0,0},
  {0,0,0,0,0,0,0,0,0,0,0,0,0,0,0,0,0,0,0,0},
  {0,0,0,0,0,0,0,0,0,0,0,0,0,0,0,0,0,0,0,0},
  {0,0,0,0,0,0,0,0,0,0,0,0,0,0,0,0,0,0,0,0},
  {0,0,0,0,0,0,0,0,0,0,0,0,0,0,0,0,0,0,0,0},
  {0,0,0,0,0,0,0,0,0,0,0,0,0,0,0,0,0,0,0,0},
  {0,0,0,0,0,0,0,0,0,0,0,0,0,0,0,0,0,0,0,0},
  {0,0,0,0,0,0,0,0,0,0,0,0,0,0,0,0,0,0,0,0},
  {0,0,0,0,0,0,0,0,0,0,0,0,0,0,0,0,0,0,0,0},
  {0,0,0,0,0,0,0,0,0,0,0,0,0,0,0,0,0,0,0,0},
  {0,0,0,0,0,0,0,0,0,0,0,0,0,0,0,0,0,0,0,0},
  {0,0,0,0,0,0,0,0,0,0,0,0,0,0,0,0,0,0,0,0},
  {0,0,0,0,0,0,0,0,0,0,0,0,0,0,0,0,0,0,0,0},
  {0,0,0,0,0,0,0,0,0,0,0,0,0,0,0,0,0,0,0,0},
  {0,0,0,0,0,0,0,0,0,0,0,0,0,0,0,0,0,0,0,0},
  {0,0,0,0,0,0,0,0,0,0,0,0,0,0,0,0,0,0,0,0},
  {0,0,0,0,0,0,0,0,0,0,0,0,0,0,0,0,0,0,0,0},
  {0,0,0,0,0,0,0,0,0,0,0,0,0,0,0,0,0,0,0,0},
  {0,0,0,0,0,0,0,0,0,0,0,0,0,0,0,0,0,0,0,0},
  {0,0,0,0,0,0,0,0,0,0,0,0,0,0,0,0,0,0,0,0},
  {0,0,0,0,0,0,0,0,0,0,0,0,0,0,0,0,0,0,0,0},
  {0,0,0,0,0,0,0,0,0,0,0,0,0,0,0,0,0,0,0,0},
  {0,0,0,0,0,0,0,0,0,0,0,0,0,0,0,0,0,0,0,0},
  {0,0,0,0,0,0,0,0,0,0,0,0,0,0,0,0,0,0,0,0},
  {0,0,0,0,0,0,0,0,0,0,0,0,0,0,0,0,0,0,0,0},
  {0,0,0,0,0,0,0,0,0,0,0,0,0,0,0,0,0,0,0,0},
  {0,0,0,0,0,0,0,0,0,0,0,0,0,0,0,0,0,0,0,0},
  {0,0,0,0,0,0,0,0,0,0,0,0,0,0,0,0,0,0,0,0}
}
loadOBJ{
  {0,0,0,0,0,0,0,0,0,0,0,0,0,0,0,0,0,0,0,0},
  {0,0,0,0,0,0,0,0,0,0,0,0,0,0,0,0,0,0,0,0},
  {0,0,0,0,0,0,0,0,0,0,0,0,0,0,0,0,0,0,0,0},
  {0,0,0,0,0,0,0,0,0,0,0,0,0,0,0,0,0,0,0,0},
  {0,0,0,0,0,0,0,0,0,0,0,0,0,0,0,0,0,0,0,0},
  {0,0,0,0,0,0,0,0,0,0,0,0,0,0,0,0,0,0,0,0},
  {0,0,0,0,0,0,0,0,0,0,0,0,0,0,0,0,0,0,0,0},
  {0,0,0,0,0,0,0,0,0,0,0,0,0,0,0,0,0,0,0,0},
  {0,0,0,0,0,0,0,0,0,0,0,0,0,0,0,0,0,0,0,0},
  {0,0,0,0,0,0,0,0,0,0,0,0,0,0,0,0,0,0,0,0},
  {0,0,0,0,0,0,0,0,0,0,0,0,0,0,0,0,0,0,0,0},
  {0,0,0,0,0,0,0,0,0,0,0,0,0,0,0,0,0,0,0,0},
  {0,0,0,0,0,0,0,0,0,0,0,0,0,0,0,0,0,0,0,0},
  {0,0,0,0,0,0,0,0,0,0,0,0,0,0,0,0,0,0,0,0},
  {0,0,0,0,0,0,0,0,0,0,0,0,0,0,0,0,0,0,0,0},
  {0,0,0,0,0,0,0,0,0,0,0,0,0,0,0,0,0,0,0,0},
  {0,0,0,0,0,0,0,0,0,0,0,0,0,0,0,0,0,0,0,0},
  {0,0,0,0,0,0,0,0,0,0,0,0,0,0,0,0,0,0,0,0},
  {0,0,0,0,0,0,0,0,0,0,0,0,0,0,0,0,0,0,0,0},
  {0,0,0,0,0,0,0,0,0,0,0,0,0,0,0,0,0,0,0,0},
  {0,0,0,0,0,0,0,0,0,0,0,0,0,0,0,0,0,0,0,0},
  {0,0,0,0,0,0,0,0,0,0,0,0,0,0,0,0,0,0,0,0},
  {0,0,0,0,0,0,0,0,0,0,0,0,0,0,0,0,0,0,0,0},
  {0,0,0,0,0,0,0,0,0,0,0,0,0,0,0,0,0,0,0,0},
  {0,0,0,0,0,0,0,0,0,0,0,0,0,0,0,0,0,0,0,0},
  {0,0,0,0,0,0,0,0,0,0,0,0,0,0,0,0,0,0,0,0},
  {0,0,0,0,0,0,0,0,0,0,0,0,0,0,0,0,0,0,0,0},
  {0,0,0,0,0,0,0,0,0,0,0,0,0,0,0,0,0,0,0,0},
  {0,0,0,0,0,0,0,0,0,0,0,0,0,0,0,0,0,0,0,0},
  {0,0,0,0,0,0,0,0,0,0,0,0,0,0,0,0,0,0,0,0},
  {0,0,0,0,0,0,0,0,0,0,0,0,0,0,0,0,0,0,0,0},
  {0,0,0,0,0,0,0,0,0,0,0,0,0,0,0,0,0,0,0,0},
  {0,0,0,0,0,0,0,0,0,0,0,0,0,0,0,0,0,0,0,0},
  {0,0,0,0,0,0,2,0,0,0,0,0,0,0,0,0,0,0,0,0},
  {0,0,0,0,0,0,0,0,0,0,0,0,0,0,0,0,0,0,0,0},
  {0,0,0,0,0,0,0,0,0,0,0,0,0,0,0,0,0,0,0,0}
}
loadWall{
  {0,0,0,0,0,0,0,0,0,0,0,0,0,0,0,14,0,0,0,0},
  {0,0,0,0,0,0,0,0,0,0,0,0,0,0,0,14,0,0,0,0},
  {0,0,0,0,0,0,0,0,0,0,0,0,0,0,0,14,0,0,0,0},
  {0,0,0,0,0,0,0,0,0,0,0,0,0,0,0,14,0,0,0,0},
  {0,0,0,0,0,0,0,0,0,0,0,0,0,0,0,15,0,0,0,0},
  {0,0,0,0,0,0,0,0,0,0,0,0,0,0,0,33,41,41,41,41},
  {0,0,0,0,0,0,0,0,0,0,0,0,0,0,0,34,42,42,42,42},
  {0,0,0,0,0,0,0,0,0,0,0,0,0,0,0,34,42,42,42,42},
  {0,0,0,0,0,0,0,0,0,0,0,0,0,0,0,34,42,42,42,42},
  {0,0,0,0,0,0,0,0,0,0,0,0,0,0,0,34,42,42,42,42},
  {0,0,0,0,0,0,0,0,0,0,0,0,0,0,97,34,42,42,42,42},
  {0,0,0,0,0,0,0,0,0,0,0,0,0,0,98,34,42,42,42,42},
  {0,0,0,0,0,0,0,0,0,0,0,0,0,0,98,34,42,42,42,42},
  {0,0,0,0,0,0,0,0,0,0,0,0,0,0,98,34,42,42,42,42},
  {0,0,0,0,0,0,0,0,0,0,0,0,0,0,98,34,42,42,42,42},
  {0,0,0,0,0,0,0,0,0,0,0,0,0,0,98,34,42,42,42,42},
  {0,0,0,0,0,0,0,0,0,0,0,0,0,0,98,34,42,42,42,42},
  {0,0,0,0,0,0,0,0,0,0,0,0,0,0,98,34,42,42,42,42},
  {41,41,41,41,41,41,41,41,49,0,0,0,0,0,98,34,42,42,42,42},
  {42,42,42,42,42,42,42,42,50,0,0,0,0,0,98,34,42,42,42,42},
  {42,42,42,42,42,42,42,42,50,0,0,0,0,0,98,34,42,42,42,42},
  {42,42,42,42,42,42,42,42,50,0,0,0,0,0,99,35,43,43,42,42},
  {42,42,42,42,42,42,42,42,50,0,0,0,0,0,0,0,0,0,34,42},
  {42,42,42,42,42,42,42,42,42,41,41,41,41,41,41,49,0,0,34,42},
  {42,42,42,42,42,42,42,42,42,42,42,42,42,42,42,50,0,0,34,42},
  {42,42,42,42,43,43,43,43,43,43,43,43,43,43,43,51,0,0,34,42},
  {42,42,42,50,0,0,0,13,0,0,0,0,0,0,0,0,0,0,34,42},
  {42,42,42,50,0,0,0,14,0,0,0,0,0,0,0,0,0,0,34,42},
  {42,42,42,50,0,0,0,15,0,0,0,0,0,0,0,0,0,0,34,42},
  {42,42,42,50,0,0,0,33,41,41,41,41,41,41,41,41,41,41,42,42},
  {42,42,42,50,0,0,0,34,42,42,42,42,42,42,42,42,42,42,42,42},
  {42,42,42,50,0,0,0,34,42,42,42,42,42,42,42,42,42,42,42,42},
  {42,42,42,50,0,0,0,34,42,42,42,42,42,42,42,42,42,42,42,42},
  {42,42,42,50,0,0,0,34,42,42,42,42,42,42,42,42,42,42,42,42},
  {42,42,42,50,0,0,0,34,42,42,42,42,42,42,42,42,42,42,42,42},
  {42,42,42,50,0,0,0,34,42,42,42,42,42,42,42,42,42,42,42,42}
}
loadCollision{
  {0,0,0,0,0,0,0,0,0,0,0,0,0,0,0,2,0,0,0,0},
  {0,0,0,0,0,0,0,0,0,0,0,0,0,0,0,2,0,0,0,0},
  {0,0,0,0,0,0,0,0,0,0,0,0,0,0,0,2,0,0,0,0},
  {0,0,0,0,0,0,0,0,0,0,0,0,0,0,0,2,0,0,0,0},
  {0,0,0,0,0,0,0,0,0,0,0,0,0,0,0,2,0,0,0,0},
  {0,0,0,0,0,0,0,0,0,0,0,0,0,0,0,1,1,1,1,1},
  {0,0,0,0,0,0,0,0,0,0,0,0,0,0,0,1,1,1,1,1},
  {0,0,0,0,0,0,0,0,0,0,0,0,0,0,0,1,1,1,1,1},
  {0,0,0,0,0,0,0,0,0,0,0,0,0,0,0,1,1,1,1,1},
  {0,0,0,0,0,0,0,0,0,0,0,0,0,0,0,1,1,1,1,1},
  {0,0,0,0,0,0,0,0,0,0,0,0,0,0,1,1,1,1,1,1},
  {0,0,0,0,0,0,0,0,0,0,0,0,0,0,1,1,1,1,1,1},
  {0,0,0,0,0,0,0,0,0,0,0,0,0,2,1,1,1,1,1,1},
  {0,0,0,0,0,0,0,0,0,0,0,0,0,2,1,1,1,1,1,1},
  {0,0,0,0,0,0,0,0,0,0,0,0,0,2,1,1,1,1,1,1},
  {0,0,0,0,0,0,0,0,0,0,0,0,0,2,1,1,1,1,1,1},
  {0,0,0,0,0,0,0,0,0,0,0,0,0,0,1,1,1,1,1,1},
  {0,0,0,0,0,0,0,0,0,0,0,0,0,0,1,1,1,1,1,1},
  {1,1,1,1,1,1,1,1,1,0,0,0,0,0,1,1,1,1,1,1},
  {1,1,1,1,1,1,1,1,1,0,0,0,0,0,1,1,1,1,1,1},
  {1,1,1,1,1,1,1,1,1,0,0,0,0,0,1,1,1,1,1,1},
  {1,1,1,1,1,1,1,1,1,0,0,0,0,0,1,1,1,1,1,1},
  {1,1,1,1,1,1,1,1,1,0,0,0,0,0,0,0,0,0,1,1},
  {1,1,1,1,1,1,1,1,1,1,1,1,1,1,1,1,0,0,1,1},
  {1,1,1,1,1,1,1,1,1,1,1,1,1,1,1,1,0,0,1,1},
  {1,1,1,1,1,1,1,1,1,1,1,1,1,1,1,1,0,0,1,1},
  {1,1,1,1,0,0,0,2,0,0,0,0,0,0,0,0,0,0,1,1},
  {1,1,1,1,0,0,0,2,0,0,0,0,0,0,0,0,0,0,1,1},
  {1,1,1,1,0,0,0,2,0,0,0,0,0,0,0,0,0,0,1,1},
  {1,1,1,1,0,0,0,1,1,1,1,1,1,1,1,1,1,1,1,1},
  {1,1,1,1,0,0,0,1,1,1,1,1,1,1,1,1,1,1,1,1},
  {1,1,1,1,0,0,0,1,1,1,1,1,1,1,1,1,1,1,1,1},
  {1,1,1,1,0,0,0,1,1,1,1,1,1,1,1,1,1,1,1,1},
  {1,1,1,1,0,0,0,1,1,1,1,1,1,1,1,1,1,1,1,1},
  {1,1,1,1,0,0,0,1,1,1,1,1,1,1,1,1,1,1,1,1},
  {1,1,1,1,0,0,0,1,1,1,1,1,1,1,1,1,1,1,1,1}
}
