mapSize(36, 25)
start{x=4,y=7}
loadBG{
  {0,0,0,0,0,0,0,0,2,10,10,10,10,10,10,10,10,10,10,10,10,10,10,10,10},
  {0,0,0,0,0,0,0,0,2,10,10,10,10,10,10,10,10,10,10,10,10,10,10,10,10},
  {0,0,0,0,0,0,0,0,2,10,10,10,10,10,10,10,10,10,10,10,10,10,10,10,10},
  {0,0,0,0,0,0,0,0,2,10,10,10,10,10,10,10,10,10,10,10,10,10,10,10,10},
  {0,0,0,0,0,0,0,0,2,10,10,10,10,10,10,10,10,10,10,10,10,10,10,10,10},
  {0,0,0,0,0,0,0,0,2,10,10,10,10,10,10,10,10,10,10,10,10,10,10,10,10},
  {0,0,0,0,0,0,0,0,2,10,10,10,10,10,10,10,10,10,10,10,10,10,10,10,10},
  {0,0,0,0,0,0,0,0,2,10,10,10,10,10,10,10,10,10,6,10,10,10,10,10,10},
  {0,0,0,0,0,0,0,0,2,10,10,10,10,10,10,10,10,10,10,10,10,10,10,10,10},
  {0,0,0,0,0,0,0,0,2,10,10,10,6,10,10,10,10,10,6,10,10,10,10,10,10},
  {0,0,0,0,0,0,0,0,2,10,10,10,10,10,10,10,10,10,10,10,10,10,10,10,10},
  {0,0,0,0,0,0,0,0,2,10,10,10,10,10,10,10,10,10,6,10,10,10,10,10,10},
  {0,0,0,0,0,0,0,0,2,10,10,10,10,10,10,10,10,10,10,10,10,10,10,10,10},
  {0,0,0,0,0,0,23,0,2,10,10,10,10,10,10,10,10,10,10,10,10,10,10,10,10},
  {0,0,0,0,0,16,24,0,2,10,10,10,10,10,10,10,10,10,10,10,10,10,10,10,10},
  {0,0,0,0,0,0,0,0,2,10,10,10,10,10,10,10,10,10,10,10,10,10,10,10,10},
  {0,0,0,0,0,0,0,0,2,10,10,10,10,10,10,10,10,10,10,10,10,10,10,10,10},
  {0,0,0,0,0,0,0,0,2,10,10,10,10,10,10,10,10,10,10,10,10,10,10,10,10},
  {0,0,0,0,0,0,0,0,2,10,10,10,10,10,10,10,10,10,10,10,10,10,10,10,10},
  {0,0,0,0,0,0,0,0,2,10,10,10,10,10,10,10,10,10,6,10,10,10,10,10,10},
  {81,89,97,8,1,9,9,9,4,10,10,10,10,10,10,10,10,10,10,10,10,10,10,10,10},
  {82,90,98,106,2,10,10,10,10,10,10,10,10,10,10,10,10,10,6,10,10,10,10,10,10},
  {83,91,99,107,2,10,10,10,10,10,6,10,10,10,10,10,10,10,10,10,10,10,10,10,10},
  {60,92,100,108,2,10,10,10,10,10,10,10,10,10,10,10,10,10,6,10,10,10,10,10,10},
  {0,93,0,0,2,10,10,10,10,10,10,10,10,10,10,10,10,10,10,10,10,10,10,10,10},
  {60,68,76,84,2,10,10,10,10,10,10,10,10,10,10,10,10,10,10,10,10,10,10,10,10},
  {61,69,77,85,2,10,10,10,10,10,10,10,10,10,10,10,10,10,10,10,10,10,10,10,10},
  {62,70,78,86,2,10,10,10,10,10,10,10,10,10,10,10,10,10,10,10,10,10,10,10,10},
  {63,71,79,87,2,10,10,10,10,10,10,10,10,10,10,10,10,10,10,10,10,10,10,10,10},
  {64,72,80,88,2,10,10,10,10,10,10,10,10,10,10,10,10,10,10,10,10,10,10,10,10},
  {0,0,101,109,2,10,10,10,10,10,10,10,10,10,10,10,10,10,10,10,10,10,10,10,10},
  {0,94,102,110,2,10,10,10,10,10,10,10,10,10,10,10,10,10,10,10,10,10,10,10,10},
  {0,95,103,111,2,10,10,10,10,10,10,10,10,10,10,10,10,10,10,10,10,10,10,10,10},
  {0,96,104,112,2,10,10,10,10,10,10,10,10,10,10,10,10,10,10,10,10,10,10,10,10},
  {0,0,0,0,2,10,10,10,10,10,10,10,10,10,10,10,10,10,10,10,10,10,10,10,10},
  {0,0,0,0,2,10,10,10,10,10,10,10,10,10,10,10,10,10,10,10,10,10,10,10,10}
}
loadFG{
  {0,0,0,0,0,0,0,0,0,0,0,0,0,0,0,0,0,0,0,0,0,0,0,0,0},
  {0,0,0,0,0,0,0,0,0,0,0,0,0,0,0,0,0,0,0,0,0,0,0,0,0},
  {0,0,0,0,0,0,0,0,0,0,0,0,0,0,0,0,0,0,0,0,0,0,0,0,0},
  {0,0,0,0,0,0,0,0,0,0,0,0,0,0,0,0,0,0,0,0,0,0,0,0,0},
  {0,0,0,0,0,0,0,0,0,0,0,0,0,0,0,0,0,0,0,0,0,0,0,0,0},
  {0,0,0,0,0,0,0,0,0,0,0,0,0,0,0,0,0,0,0,0,0,0,0,0,0},
  {0,0,0,0,0,0,0,0,0,0,0,0,0,0,0,0,0,0,0,0,0,0,0,0,0},
  {0,0,0,0,0,0,0,0,0,0,0,0,0,0,0,0,0,0,0,0,0,0,0,0,0},
  {0,0,0,0,0,0,0,0,0,0,0,0,0,0,0,0,0,0,0,0,0,0,0,0,0},
  {0,0,0,0,0,0,0,0,0,0,0,0,0,0,0,0,0,0,0,0,0,0,0,0,0},
  {0,0,0,0,0,0,0,0,0,0,0,0,0,0,0,0,0,0,0,0,0,0,0,0,0},
  {0,0,0,0,0,0,0,0,0,0,0,0,0,0,0,0,0,0,0,0,0,0,0,0,0},
  {0,0,0,0,0,0,0,0,0,0,0,0,0,0,0,0,0,0,0,0,0,0,0,0,0},
  {0,0,0,0,0,0,0,0,0,0,0,0,0,0,0,0,0,0,0,0,0,0,0,0,0},
  {0,0,0,0,0,0,0,0,0,0,0,0,0,0,0,0,0,0,0,0,0,0,0,0,0},
  {0,0,0,0,0,0,0,0,0,0,0,0,0,0,0,0,0,0,0,0,0,0,0,0,0},
  {0,0,0,0,0,0,0,0,0,0,0,0,0,0,0,0,0,0,0,0,0,0,0,0,0},
  {0,0,0,0,0,0,0,0,0,0,0,0,0,0,0,0,0,0,0,0,0,0,0,0,0},
  {0,0,0,0,0,0,0,0,0,0,0,0,0,0,0,0,0,0,0,0,0,0,0,0,0},
  {0,0,0,0,0,0,0,0,0,0,0,0,0,0,0,0,0,0,0,0,0,0,0,0,0},
  {0,0,0,0,0,0,0,0,0,0,0,0,0,0,0,0,0,0,0,0,0,0,0,0,0},
  {0,0,0,0,0,0,0,0,0,0,0,0,0,0,0,0,0,0,0,0,0,0,0,0,0},
  {0,0,0,0,0,0,0,0,0,0,0,0,0,0,0,0,0,0,0,0,0,0,0,0,0},
  {0,0,0,0,0,0,0,0,0,0,0,0,0,0,0,0,0,0,0,0,0,0,0,0,0},
  {0,0,0,0,0,0,0,0,0,0,0,0,0,0,0,0,0,0,0,0,0,0,0,0,0},
  {0,0,0,0,0,0,0,0,0,0,0,0,0,0,0,0,0,0,0,0,0,0,0,0,0},
  {0,0,0,0,0,0,0,0,0,0,0,0,0,0,0,0,0,0,0,0,0,0,0,0,0},
  {0,0,0,0,0,0,0,0,0,0,0,0,0,0,0,0,0,0,0,0,0,0,0,0,0},
  {0,0,0,0,0,0,0,0,0,0,0,0,0,0,0,0,0,0,0,0,0,0,0,0,0},
  {0,0,0,0,0,0,0,0,0,0,0,0,0,0,0,0,0,0,0,0,0,0,0,0,0},
  {0,0,0,0,0,0,0,0,0,0,0,0,0,0,0,0,0,0,0,0,0,0,0,0,0},
  {0,0,0,0,0,0,0,0,0,0,0,0,0,0,0,0,0,0,0,0,0,0,0,0,0},
  {0,0,0,0,0,0,0,0,0,0,0,0,0,0,0,0,0,0,0,0,0,0,0,0,0},
  {0,0,0,0,0,0,0,0,0,0,0,0,0,0,0,0,0,0,0,0,0,0,0,0,0},
  {0,0,0,0,0,0,0,0,0,0,0,0,0,0,0,0,0,0,0,0,0,0,0,0,0},
  {0,0,0,0,0,0,0,0,0,0,0,0,0,0,0,0,0,0,0,0,0,0,0,0,0}
}
loadOBJ{
  {0,0,0,0,0,0,0,0,0,0,0,0,0,0,0,0,0,0,0,0,0,0,0,0,0},
  {0,0,0,0,0,0,0,0,0,0,0,0,0,0,0,0,0,0,0,0,0,0,0,0,0},
  {0,0,0,0,0,0,0,0,0,0,0,0,0,0,0,0,0,0,0,0,0,0,0,0,0},
  {0,0,0,0,0,0,0,0,0,0,0,0,0,0,0,0,0,0,0,0,0,0,0,0,0},
  {0,0,0,0,0,0,0,0,0,0,0,0,0,73,0,0,0,0,0,0,0,0,0,0,0},
  {0,0,0,0,0,0,0,0,0,0,0,0,0,0,0,0,0,0,0,0,0,0,0,0,0},
  {0,0,0,0,0,0,0,0,0,0,0,0,0,0,0,0,0,0,0,0,0,0,74,0,0},
  {0,0,0,0,0,0,0,0,0,0,0,0,0,0,0,0,0,0,0,0,0,0,0,0,0},
  {0,0,0,0,0,0,0,74,0,0,0,0,0,0,0,0,0,0,0,0,0,0,74,0,0},
  {0,0,0,0,0,0,0,0,0,0,0,0,0,0,74,0,0,0,0,0,0,0,0,0,0},
  {0,0,0,0,0,0,0,0,0,0,0,0,0,0,0,0,0,0,0,0,0,0,74,0,0},
  {0,0,0,0,0,0,0,0,0,0,0,0,0,0,0,0,0,0,0,0,0,0,0,0,0},
  {0,0,0,0,0,0,0,0,0,0,73,0,0,0,0,0,0,0,0,0,0,0,74,0,0},
  {0,0,0,0,0,0,0,0,0,0,0,0,0,0,0,0,0,0,0,0,0,0,0,0,0},
  {0,0,0,0,0,0,0,0,0,0,0,74,0,0,0,0,0,0,0,0,0,0,0,0,0},
  {0,0,0,0,0,0,0,0,0,0,0,0,0,0,0,0,0,0,0,0,0,0,0,0,0},
  {0,0,0,0,0,0,0,0,0,0,0,0,0,0,0,0,0,0,0,0,0,0,0,0,0},
  {0,0,0,0,0,0,0,0,0,0,0,0,0,0,0,0,0,0,0,0,0,0,0,0,0},
  {0,0,0,0,0,0,0,0,0,0,0,0,0,0,0,0,0,0,0,0,0,0,0,0,0},
  {0,0,0,0,0,0,0,0,0,0,0,0,0,0,0,0,0,0,0,0,0,0,0,76,0},
  {0,0,0,0,0,0,0,0,0,0,0,0,0,0,0,0,0,0,0,0,0,0,0,0,0},
  {0,0,0,0,0,0,0,0,0,0,0,0,0,0,0,0,0,0,0,0,0,0,0,76,0},
  {0,0,0,0,0,0,0,0,0,0,0,0,0,0,0,0,0,0,0,0,0,0,0,0,0},
  {0,0,0,0,0,0,0,0,0,0,0,0,0,0,0,0,0,0,0,0,0,0,0,76,0},
  {0,0,0,0,0,0,74,0,0,0,0,0,0,0,0,0,0,0,0,0,0,0,0,0,0},
  {0,0,0,0,0,0,0,0,0,0,0,0,0,0,0,0,0,0,0,0,0,0,0,76,0},
  {0,0,0,0,0,0,0,0,0,0,0,0,0,0,0,0,0,0,0,0,0,0,0,0,0},
  {0,0,0,0,0,0,0,0,0,0,0,0,0,0,0,0,0,0,0,0,0,0,0,0,0},
  {0,0,0,0,0,0,0,0,0,0,0,0,0,0,0,0,0,0,0,0,0,0,0,0,0},
  {0,0,0,0,0,0,0,0,0,0,0,0,0,0,0,0,0,0,0,0,0,73,0,0,0},
  {0,0,0,0,0,0,0,0,0,0,0,0,0,0,0,0,0,0,0,0,73,0,0,0,0},
  {0,0,0,0,0,0,0,0,0,0,0,0,0,0,0,0,0,0,0,73,0,0,0,0,0},
  {0,0,0,0,0,0,0,0,0,0,0,0,0,0,0,0,0,0,0,0,0,0,0,0,0},
  {0,0,0,0,0,0,0,0,0,0,0,0,0,0,0,0,0,0,0,0,0,2,0,0,0},
  {0,0,0,0,0,0,0,0,0,0,0,0,0,0,0,0,0,0,0,0,0,0,0,0,0},
  {0,0,0,0,0,0,0,0,0,0,0,0,0,0,0,0,0,0,0,0,0,0,0,0,0}
}
loadWall{
  {0,11,19,18,18,18,18,18,18,18,18,18,18,18,18,18,18,18,18,18,18,18,18,18,18},
  {0,0,0,11,19,19,19,18,18,18,19,19,19,19,19,19,19,19,19,19,19,19,18,18,18},
  {0,0,0,0,0,0,0,10,18,26,0,0,0,0,0,0,0,0,0,0,0,0,10,18,18},
  {0,0,0,0,0,0,0,11,18,26,0,0,0,0,0,0,0,0,0,0,0,0,10,18,18},
  {0,0,0,0,0,0,0,0,10,26,0,0,0,0,9,17,17,20,20,28,0,0,10,18,18},
  {0,0,0,0,0,0,0,0,10,26,0,0,0,0,11,18,27,0,0,0,0,0,11,19,18},
  {0,0,0,0,0,0,0,0,10,18,25,0,0,0,0,2,0,0,0,0,0,0,0,0,10},
  {0,0,0,0,0,0,0,0,10,18,18,28,0,0,0,2,0,0,0,0,0,0,0,0,10},
  {0,0,0,0,0,0,0,0,10,19,27,0,0,0,0,2,0,0,0,0,0,0,0,0,10},
  {0,0,0,0,0,0,0,0,2,0,0,0,0,0,0,2,0,0,0,0,0,0,0,0,10},
  {0,0,0,0,0,0,0,0,2,0,0,0,0,0,0,2,0,0,0,0,0,0,0,0,10},
  {0,0,0,0,0,0,0,9,26,0,0,0,0,0,0,2,0,0,0,0,0,0,0,0,10},
  {0,0,0,0,0,0,0,10,26,0,0,9,17,17,17,26,0,0,0,0,0,0,0,0,10},
  {0,0,0,0,0,0,0,10,26,0,0,11,18,18,18,26,0,0,0,0,0,0,0,0,10},
  {0,0,0,0,0,0,0,10,26,0,0,0,10,18,18,26,0,0,0,0,0,0,0,0,10},
  {0,0,0,0,0,0,0,11,18,20,28,0,10,18,18,26,0,0,0,0,0,0,0,0,10},
  {0,0,0,0,0,0,0,0,2,0,0,0,10,18,18,26,0,0,0,0,0,0,0,0,10},
  {0,0,0,0,0,0,0,0,2,0,0,0,10,18,18,26,0,0,0,0,0,0,0,0,10},
  {0,0,0,0,0,0,0,0,2,0,1,0,10,18,18,26,0,0,0,0,0,0,0,0,10},
  {0,0,0,0,0,0,0,0,2,0,2,0,10,18,18,26,0,0,0,0,0,0,0,0,10},
  {0,0,0,0,9,20,28,0,2,0,3,0,10,18,18,26,0,0,0,0,0,0,0,0,10},
  {0,0,0,0,2,0,0,0,2,0,0,0,10,18,18,26,0,0,0,0,0,0,0,0,10},
  {0,0,0,0,2,0,0,0,2,0,0,0,10,18,18,26,0,0,0,0,0,0,0,0,10},
  {0,0,0,0,2,0,0,9,26,0,0,0,10,18,18,26,0,0,0,0,0,0,0,0,10},
  {0,0,0,0,2,0,0,10,18,17,25,0,10,18,18,26,0,0,0,0,0,0,0,0,10},
  {0,0,0,0,2,0,0,11,19,19,27,0,10,18,18,26,0,0,0,0,0,0,0,0,10},
  {0,0,0,0,2,0,0,0,0,0,0,0,10,18,18,26,0,0,0,0,0,0,9,17,18},
  {0,0,0,0,10,17,17,17,17,17,17,17,18,18,18,18,17,17,17,25,0,0,10,18,18},
  {0,0,0,0,10,18,18,18,18,18,18,18,18,18,18,18,18,18,18,27,0,0,10,18,18},
  {0,0,0,0,10,18,18,18,18,18,18,18,18,18,18,18,18,18,26,0,0,0,10,18,18},
  {0,0,0,0,10,18,18,18,18,18,18,18,18,18,18,18,18,18,26,0,0,0,10,18,18},
  {0,0,0,0,10,18,18,18,18,18,18,18,18,18,18,18,18,18,27,0,0,0,10,18,18},
  {0,0,0,0,10,18,18,18,18,18,18,18,18,18,18,18,18,26,0,0,0,0,10,18,18},
  {0,0,0,0,10,18,18,18,18,18,18,18,18,18,18,18,18,26,0,0,0,0,10,18,18},
  {0,0,0,0,10,18,18,18,18,18,18,18,18,18,18,18,18,18,17,17,17,17,18,18,18},
  {0,0,0,0,10,18,18,18,18,18,18,18,18,18,18,18,18,18,18,18,18,18,18,18,18}
}
loadCollision{
  {0,1,1,1,1,1,1,1,1,1,1,1,1,1,1,1,1,1,1,1,1,1,1,1,1},
  {0,0,0,1,1,1,1,1,1,1,1,1,1,1,1,1,1,1,1,1,1,1,1,1,1},
  {0,0,0,0,0,0,0,1,1,1,0,0,0,0,0,0,0,0,0,0,0,0,1,1,1},
  {0,0,0,0,0,0,0,1,1,1,0,0,0,0,0,0,0,0,0,0,0,0,1,1,1},
  {0,0,0,0,0,0,0,0,1,1,0,0,0,0,1,1,1,1,1,1,0,0,1,1,1},
  {0,0,0,0,0,0,0,0,1,1,0,0,0,0,1,1,1,0,0,0,0,0,1,1,1},
  {0,0,0,0,0,0,0,0,1,1,1,0,0,0,0,1,0,0,0,0,0,0,0,0,1},
  {0,0,0,0,0,0,0,0,1,1,1,1,0,0,0,1,0,0,0,0,0,0,0,0,1},
  {0,0,0,0,0,0,0,0,1,1,1,0,0,0,0,1,0,0,0,0,0,0,0,0,1},
  {0,0,0,0,0,0,0,0,1,0,0,0,0,0,0,1,0,0,0,0,0,0,0,0,1},
  {0,0,0,0,0,0,0,0,1,0,0,0,0,0,0,1,0,0,0,0,0,0,0,0,1},
  {0,0,0,0,0,0,0,1,1,0,0,0,0,0,0,1,0,0,0,0,0,0,0,0,1},
  {0,0,0,0,0,0,0,1,1,0,0,1,1,1,1,1,0,0,0,0,0,0,0,0,1},
  {0,0,0,0,0,0,0,1,1,0,0,1,1,1,1,1,0,0,0,0,0,0,0,0,1},
  {0,0,0,0,0,0,0,1,1,0,0,0,1,1,1,1,0,0,0,0,0,0,0,0,1},
  {0,0,0,0,0,0,0,1,1,1,1,0,1,1,1,1,0,0,0,0,0,0,0,0,1},
  {0,0,0,0,0,0,0,0,1,0,0,0,1,1,1,1,0,0,0,0,0,0,0,0,1},
  {0,0,0,0,0,0,0,0,1,0,0,0,1,1,1,1,0,0,0,0,0,0,0,0,1},
  {0,0,0,0,0,0,0,0,1,0,1,0,1,1,1,1,0,0,0,0,0,0,0,0,1},
  {0,0,0,0,0,0,0,0,1,0,1,0,1,1,1,1,0,0,0,0,0,0,0,0,1},
  {0,0,0,0,1,1,1,0,1,0,1,0,1,1,1,1,0,0,0,0,0,0,0,0,1},
  {0,0,0,0,1,0,0,0,1,0,0,0,1,1,1,1,0,0,0,0,0,0,0,0,1},
  {0,0,0,0,1,0,0,0,1,0,0,0,1,1,1,1,0,0,0,0,0,0,0,0,1},
  {0,0,0,0,1,0,0,1,1,0,0,0,1,1,1,1,0,0,0,0,0,0,0,0,1},
  {0,0,0,0,1,0,0,1,1,1,1,0,1,1,1,1,0,0,0,0,0,0,0,0,1},
  {0,0,0,0,1,0,0,1,1,1,1,0,1,1,1,1,0,0,0,0,0,0,0,0,1},
  {0,0,0,0,1,0,0,0,0,0,0,0,1,1,1,1,0,0,0,0,0,0,1,1,1},
  {0,0,0,0,1,1,1,1,1,1,1,1,1,1,1,1,1,1,1,1,0,0,1,1,1},
  {0,0,0,0,1,1,1,1,1,1,1,1,1,1,1,1,1,1,1,1,0,0,1,1,1},
  {0,0,0,0,1,1,1,1,1,1,1,1,1,1,1,1,1,1,1,0,0,0,1,1,1},
  {0,0,0,0,1,1,1,1,1,1,1,1,1,1,1,1,1,1,1,0,0,0,1,1,1},
  {0,0,0,0,1,1,1,1,1,1,1,1,1,1,1,1,1,1,1,0,0,0,1,1,1},
  {0,0,0,0,1,1,1,1,1,1,1,1,1,1,1,1,1,1,0,0,0,0,1,1,1},
  {0,0,0,0,1,1,1,1,1,1,1,1,1,1,1,1,1,1,0,0,0,0,1,1,1},
  {0,0,0,0,1,1,1,1,1,1,1,1,1,1,1,1,1,1,1,1,1,1,1,1,1},
  {0,0,0,0,1,1,1,1,1,1,1,1,1,1,1,1,1,1,1,1,1,1,1,1,1}
}
