mapSize(77, 20)
start{x=9,y=13}
loadBG{
  {0,0,0,0,0,0,0,0,0,0,0,0,0,0,0,0,0,0,0,0},
  {0,0,0,0,0,0,0,0,0,0,0,0,0,0,0,0,0,0,0,0},
  {0,0,0,0,0,0,0,0,0,0,0,0,0,0,0,0,0,0,0,0},
  {0,0,0,0,0,0,0,0,0,0,0,0,0,0,0,0,0,0,0,0},
  {0,0,0,0,0,0,0,0,0,0,0,0,0,0,0,0,0,0,0,0},
  {0,0,0,0,0,0,0,0,0,0,0,0,0,0,0,0,0,0,0,0},
  {0,0,0,0,0,0,0,0,0,0,0,0,0,0,0,0,0,0,0,0},
  {0,0,0,0,0,0,0,0,0,0,0,0,0,0,0,0,0,0,0,0},
  {0,81,89,97,105,0,0,0,0,0,0,0,0,0,0,0,0,0,0,0},
  {0,82,90,98,106,0,0,0,0,0,0,0,0,0,0,0,0,0,0,0},
  {0,83,91,99,107,0,0,0,0,0,0,0,0,0,0,0,0,0,0,0},
  {0,0,92,100,108,0,0,0,0,0,0,0,0,0,0,0,0,0,0,0},
  {0,0,93,0,0,0,0,0,0,0,0,0,0,0,0,0,0,0,0,0},
  {0,0,0,0,0,0,8,0,0,0,0,0,0,0,0,0,0,0,0,0},
  {0,0,0,0,0,0,0,0,0,0,0,0,0,0,0,0,0,0,0,0},
  {0,0,0,0,0,0,0,0,0,0,0,0,0,0,0,0,0,0,0,0},
  {0,0,0,0,0,0,0,0,0,0,0,0,0,0,0,0,0,0,0,0},
  {0,0,0,0,0,0,0,0,0,0,0,0,0,0,0,0,0,0,0,0},
  {0,0,0,0,0,0,0,0,0,0,0,0,0,0,0,0,0,0,0,0},
  {0,0,0,0,0,0,0,0,0,0,0,0,0,0,0,0,0,0,0,0},
  {0,0,0,0,0,0,0,0,0,0,0,0,0,0,0,0,0,0,0,0},
  {0,0,0,0,0,0,0,0,0,0,0,0,0,0,0,0,0,0,0,0},
  {0,0,0,0,0,0,0,0,0,0,0,0,0,0,0,0,0,0,0,0},
  {0,0,0,0,0,0,0,0,0,0,0,0,0,0,21,0,0,0,0,0},
  {0,0,0,0,0,0,0,0,0,0,0,0,0,14,22,0,0,0,0,0},
  {0,0,0,0,0,0,0,0,0,0,0,0,0,0,0,0,0,0,0,0},
  {0,0,0,0,0,0,0,0,0,0,0,0,0,0,0,0,0,0,0,0},
  {0,0,0,0,0,0,0,0,0,0,0,0,0,0,0,0,0,0,0,0},
  {0,0,0,0,0,0,0,0,0,0,0,0,0,0,0,0,0,0,0,0},
  {0,0,0,0,0,0,0,0,0,0,0,0,0,0,0,0,0,0,0,0},
  {0,0,0,0,0,0,0,0,0,0,0,0,0,0,0,0,0,0,0,0},
  {0,0,0,0,0,0,0,0,0,0,0,0,0,0,0,0,0,0,0,0},
  {0,0,0,0,0,0,0,0,0,0,0,0,0,0,0,0,0,0,0,0},
  {0,0,0,0,0,0,0,0,0,0,0,0,0,0,0,0,0,0,0,0},
  {0,0,0,0,0,0,0,21,0,0,0,0,0,0,0,0,0,0,0,0},
  {0,0,0,0,0,0,14,22,0,0,0,0,0,0,0,0,0,0,0,0},
  {0,0,0,0,0,0,0,0,0,0,0,0,0,0,0,0,0,0,0,0},
  {0,0,0,0,0,0,0,0,0,0,0,0,0,0,0,0,0,0,0,0},
  {0,0,0,0,0,0,0,0,0,0,0,0,0,0,0,0,0,0,0,0},
  {0,0,0,0,0,0,0,0,0,0,0,0,0,0,0,0,0,0,0,0},
  {0,0,0,0,0,0,0,0,0,0,0,0,0,0,0,0,0,0,0,0},
  {0,0,0,0,0,0,0,101,109,0,0,0,0,0,0,0,0,0,0,0},
  {0,0,0,0,0,0,94,102,110,0,0,0,0,0,0,0,0,0,0,0},
  {0,0,0,0,0,0,95,103,111,0,0,0,0,0,0,0,0,0,0,0},
  {0,0,0,0,0,0,96,104,112,0,0,0,0,0,0,0,0,0,0,0},
  {0,0,0,0,0,0,0,0,0,0,0,0,0,0,0,0,0,0,0,0},
  {0,0,0,0,0,0,0,0,0,0,0,0,0,0,0,0,0,0,0,0},
  {0,0,0,23,0,0,0,0,0,0,0,0,0,0,0,0,0,0,0,0},
  {0,0,16,24,0,0,0,0,0,0,0,0,0,0,0,0,0,0,0,0},
  {0,0,0,0,0,0,0,0,0,0,0,0,0,0,0,0,0,0,0,0},
  {0,0,0,0,0,0,0,0,0,0,0,0,0,0,0,0,0,0,0,0},
  {0,0,0,0,0,0,0,0,0,0,0,0,0,0,0,0,0,0,0,0},
  {0,0,0,0,0,0,0,0,0,0,0,0,0,0,0,0,0,0,0,0},
  {0,0,0,0,0,0,0,0,0,0,0,0,0,0,0,0,0,0,0,0},
  {0,0,0,0,0,0,0,0,0,0,0,0,0,0,0,0,0,0,0,0},
  {0,0,0,0,0,0,0,0,0,0,0,0,0,0,0,0,0,0,0,0},
  {0,0,0,0,0,0,0,0,0,0,0,0,0,0,0,0,0,0,0,0},
  {0,0,0,0,0,0,0,0,0,0,0,0,0,0,0,0,0,0,0,0},
  {0,0,0,0,0,0,0,0,0,0,0,0,0,0,0,0,0,0,0,0},
  {0,0,0,0,0,0,0,0,0,0,0,0,0,0,0,0,0,0,0,0},
  {0,0,0,0,0,0,0,0,0,0,0,0,0,0,0,0,0,0,0,0},
  {0,0,0,0,0,0,0,0,0,0,0,0,0,0,0,0,0,0,0,0},
  {0,0,0,0,0,0,0,0,0,0,0,0,0,0,0,0,0,0,0,0},
  {0,0,0,0,0,0,0,0,0,0,0,0,0,0,0,0,0,0,0,0},
  {0,0,0,0,0,0,0,0,0,0,0,0,0,0,0,0,0,0,0,0},
  {0,0,0,0,0,0,0,0,0,0,0,0,0,0,0,0,0,0,0,0},
  {0,0,0,0,0,0,0,0,0,0,0,0,0,0,0,0,0,0,0,0},
  {0,0,0,0,0,0,0,0,0,0,0,0,0,0,0,0,0,0,0,0},
  {0,0,0,0,0,0,0,0,0,0,0,0,0,0,0,0,0,0,0,0},
  {0,0,0,0,0,0,0,0,0,0,0,0,0,0,0,0,0,0,0,0},
  {0,0,0,0,0,0,0,0,0,0,0,0,0,0,0,0,0,0,0,0},
  {0,0,0,0,0,0,0,0,0,0,0,0,0,0,0,0,0,0,0,0},
  {0,0,0,0,0,0,0,0,0,0,0,0,0,0,0,0,0,0,0,0},
  {0,0,0,0,0,0,0,0,0,0,0,0,0,0,0,0,0,0,0,0},
  {0,0,0,0,0,0,0,0,0,0,0,0,0,0,0,0,0,0,0,0},
  {0,0,0,0,0,0,0,0,0,0,0,0,0,0,0,0,0,0,0,0},
  {0,0,0,0,0,0,0,0,0,0,0,0,0,0,0,0,0,0,0,0}
}
loadFG{
  {0,0,0,0,0,0,0,0,0,0,0,0,0,0,0,0,0,0,0,0},
  {0,0,0,0,0,0,0,0,0,0,0,0,0,0,0,0,0,0,0,0},
  {0,0,0,0,0,0,0,0,0,0,0,0,0,0,0,0,0,0,0,0},
  {0,0,0,0,0,0,0,0,0,0,0,0,0,0,0,0,0,0,0,0},
  {0,0,0,0,0,0,0,0,0,0,0,0,0,0,0,0,0,0,0,0},
  {0,0,0,0,0,0,0,0,0,0,0,0,0,0,0,0,0,0,0,0},
  {0,0,0,0,0,0,0,0,0,0,0,0,0,0,0,0,0,0,0,0},
  {0,0,0,0,0,0,0,0,0,0,0,0,0,0,0,0,0,0,0,0},
  {0,0,0,0,0,0,0,0,0,0,0,0,0,0,0,0,0,0,0,0},
  {0,0,0,0,0,0,0,0,0,0,0,0,0,0,0,0,0,0,0,0},
  {0,0,0,0,0,0,0,0,0,0,0,0,0,0,0,0,0,0,0,0},
  {0,0,0,0,0,0,0,0,0,0,0,0,0,0,0,0,0,0,0,0},
  {0,0,0,0,0,0,0,0,0,0,0,0,0,0,0,0,0,0,0,0},
  {0,0,0,0,0,0,0,0,0,0,0,0,0,0,0,0,0,0,0,0},
  {0,0,0,0,0,0,0,0,0,0,0,0,0,0,0,0,0,0,0,0},
  {0,0,0,0,0,0,0,0,0,0,0,0,0,0,0,0,0,0,0,0},
  {0,0,0,0,0,0,0,0,0,0,0,0,0,0,0,0,0,0,0,0},
  {0,0,0,0,0,0,0,0,0,0,0,0,0,0,0,0,0,0,0,0},
  {0,0,0,0,0,0,0,0,0,43,51,51,0,0,0,0,0,0,0,0},
  {0,0,0,0,0,0,0,0,0,0,0,0,0,0,0,0,0,0,0,0},
  {0,0,0,0,0,0,0,0,0,0,0,0,0,0,0,0,0,0,0,0},
  {0,0,0,0,0,0,0,0,0,0,0,0,0,0,0,0,0,0,0,0},
  {0,0,0,0,0,0,0,52,52,52,52,60,0,0,0,0,0,0,0,0},
  {0,0,0,0,0,0,0,0,0,0,0,0,0,0,0,0,0,0,0,0},
  {0,0,0,0,0,0,0,0,0,0,0,0,0,0,0,0,0,0,0,0},
  {0,0,0,0,0,0,0,0,0,0,0,0,0,0,0,0,0,0,0,0},
  {0,0,0,0,0,0,0,0,0,0,0,0,0,0,0,0,0,0,0,0},
  {0,0,0,0,0,0,0,0,0,0,0,0,0,0,0,0,0,0,0,0},
  {0,0,0,0,0,0,0,0,0,0,0,0,0,0,0,0,0,0,0,0},
  {0,0,0,0,0,0,0,0,0,0,0,0,0,0,0,0,0,0,0,0},
  {0,0,0,0,0,0,0,52,52,52,52,60,0,0,0,0,0,0,0,0},
  {0,0,0,0,0,0,0,0,0,0,0,0,0,0,0,0,0,0,0,0},
  {0,0,0,0,0,0,0,0,0,0,0,0,0,0,0,0,0,0,0,0},
  {0,0,0,0,0,0,0,0,0,0,0,0,0,0,0,0,0,0,0,0},
  {0,0,0,0,0,0,0,0,0,0,0,0,0,0,0,0,0,0,0,0},
  {0,0,0,0,0,0,0,0,0,0,0,0,0,0,0,0,0,0,0,0},
  {0,0,0,0,0,0,0,0,0,0,0,0,0,0,0,0,0,0,0,0},
  {0,0,0,0,0,0,0,0,0,0,0,0,0,0,0,0,0,0,0,0},
  {0,0,0,0,0,0,0,0,0,0,0,0,0,0,0,0,0,0,0,0},
  {0,0,0,0,0,0,0,0,0,41,49,49,49,0,0,0,0,0,0,0},
  {0,0,0,0,0,0,0,0,0,42,0,0,0,0,0,0,0,0,0,0},
  {0,0,0,0,0,0,0,0,0,0,0,0,0,0,0,0,0,0,0,0},
  {0,0,0,0,0,0,0,0,0,0,0,0,0,0,0,0,0,0,0,0},
  {0,0,0,0,0,0,0,0,0,0,0,0,0,0,0,0,0,0,0,0},
  {0,0,0,0,0,0,0,0,0,0,0,0,0,0,0,0,0,0,0,0},
  {0,0,0,0,0,0,0,0,0,42,0,0,0,0,0,0,0,0,0,0},
  {0,0,0,0,0,0,0,0,0,43,51,51,51,0,0,0,0,0,0,0},
  {0,0,0,0,0,0,0,0,0,0,0,0,0,0,0,0,0,0,0,0},
  {0,0,0,0,0,0,0,0,0,0,0,0,0,0,0,0,0,0,0,0},
  {0,0,0,0,0,0,0,0,0,0,0,0,0,0,0,0,0,0,0,0},
  {0,0,0,0,0,0,0,0,0,0,0,0,0,0,0,0,0,0,0,0},
  {0,0,0,0,0,0,0,0,0,0,0,0,0,0,0,0,0,0,0,0},
  {0,0,0,0,0,0,0,0,0,0,0,0,0,0,0,0,0,0,0,0},
  {0,0,0,0,0,0,0,0,0,0,0,0,0,0,0,0,0,0,0,0},
  {0,0,0,0,0,0,0,0,0,0,0,0,0,0,0,0,0,0,0,0},
  {0,0,0,0,0,0,0,0,0,0,0,0,42,0,0,0,0,0,0,0},
  {0,0,0,0,0,0,0,0,0,0,0,0,42,0,0,0,0,0,0,0},
  {0,0,0,0,0,0,0,0,0,0,0,0,42,0,0,0,0,0,0,0},
  {0,0,0,0,0,0,0,0,0,0,0,0,42,0,0,0,0,0,0,0},
  {0,0,0,0,0,0,0,0,0,0,0,0,42,0,0,0,0,0,0,0},
  {0,0,0,0,0,0,0,0,0,0,0,0,42,0,0,0,0,0,0,0},
  {0,0,0,0,0,0,0,0,0,0,0,0,42,0,0,0,0,0,0,0},
  {0,0,0,0,0,0,0,0,0,0,0,0,42,0,0,0,0,0,0,0},
  {0,0,0,0,0,0,0,0,0,0,0,0,42,0,0,0,0,0,0,0},
  {0,0,0,0,0,0,0,0,0,0,0,0,42,0,0,0,0,0,0,0},
  {0,0,0,0,0,0,0,0,0,0,0,0,42,0,0,0,0,0,0,0},
  {0,0,0,0,0,0,0,0,0,0,0,0,42,0,0,0,0,0,0,0},
  {0,0,0,0,0,0,0,0,0,0,0,0,42,0,0,0,0,0,0,0},
  {0,0,0,0,0,0,0,0,0,0,0,0,42,0,0,0,0,0,0,0},
  {0,0,0,0,0,0,0,0,0,0,0,0,0,0,0,0,0,0,0,0},
  {0,0,0,0,0,0,0,0,0,0,0,0,0,0,0,0,0,0,0,0},
  {0,0,0,0,0,0,0,0,0,0,0,0,0,0,0,0,0,0,0,0},
  {0,0,0,0,0,0,0,0,0,0,0,0,0,0,0,0,0,0,0,0},
  {0,0,0,0,0,0,0,0,0,0,0,0,0,0,0,0,0,0,0,0},
  {0,0,0,0,0,0,0,0,0,0,0,0,0,0,0,0,0,0,0,0},
  {0,0,0,0,0,0,0,0,0,0,0,0,0,0,0,0,0,0,0,0},
  {0,0,0,0,0,0,0,0,0,0,0,0,0,0,0,0,0,0,0,0}
}
loadOBJ{
  {0,0,0,0,0,0,0,0,0,0,0,0,0,0,0,0,0,0,0,0},
  {0,0,0,0,0,0,0,0,0,0,0,0,0,0,0,0,0,0,0,0},
  {0,0,0,0,0,0,0,0,0,0,0,0,0,0,0,0,0,0,0,0},
  {0,0,0,0,0,0,0,0,0,0,0,0,17,0,0,0,0,0,0,0},
  {0,0,0,0,0,0,0,0,0,0,0,0,0,0,0,0,0,0,0,0},
  {0,0,0,0,0,0,0,0,0,0,0,0,0,0,0,0,0,0,0,0},
  {0,0,0,0,0,0,0,0,0,0,0,0,0,0,0,0,0,0,0,0},
  {0,0,0,0,0,0,0,0,0,0,0,0,0,0,0,0,0,0,0,0},
  {0,0,0,0,0,0,0,0,0,0,0,0,0,0,0,0,0,0,0,0},
  {0,0,0,0,0,0,0,0,0,0,0,0,0,0,0,0,0,0,0,0},
  {0,0,0,0,0,0,0,0,0,0,0,0,0,0,0,0,0,0,0,0},
  {0,0,0,0,0,0,0,0,0,0,0,0,0,0,0,0,0,0,0,0},
  {0,0,0,0,0,0,0,0,0,0,0,19,19,0,0,0,0,0,0,0},
  {0,0,0,0,0,0,0,0,0,0,0,0,0,0,0,0,0,0,0,0},
  {0,0,0,0,0,0,0,0,0,0,0,0,0,0,0,0,0,0,0,0},
  {0,0,0,0,0,0,0,0,0,0,0,0,0,0,0,0,0,0,0,0},
  {0,0,0,0,0,0,0,0,0,0,0,0,0,0,0,0,0,0,0,0},
  {0,0,0,0,0,0,0,0,0,0,0,0,0,0,0,0,0,0,0,0},
  {0,0,0,0,0,0,0,0,0,33,33,33,0,0,0,0,0,0,0,0},
  {0,0,0,0,0,0,0,0,0,0,0,0,0,0,0,0,0,0,0,0},
  {0,0,0,0,0,0,0,0,0,0,0,0,0,0,0,0,0,0,0,0},
  {0,0,0,0,0,0,0,0,0,0,0,0,0,0,0,0,0,0,0,0},
  {0,0,0,0,0,0,0,33,33,33,33,33,0,0,0,0,0,0,0,0},
  {0,0,0,0,0,0,0,0,0,0,0,0,0,0,0,0,0,0,0,0},
  {0,0,0,0,0,0,0,0,0,0,0,0,0,0,0,0,0,0,0,0},
  {0,0,0,0,0,0,0,0,0,0,0,0,0,0,0,0,0,0,0,0},
  {0,0,0,0,0,0,0,0,0,0,0,0,0,0,17,0,0,0,0,0},
  {0,0,0,0,0,0,0,0,0,0,0,0,0,0,0,0,0,0,0,0},
  {0,0,0,0,0,0,0,0,0,0,0,0,0,0,0,0,0,0,0,0},
  {0,0,0,0,0,0,0,0,0,0,0,0,0,0,0,0,0,0,0,0},
  {0,0,0,0,0,0,0,33,33,33,33,33,18,18,18,0,0,0,0,0},
  {0,0,0,0,0,17,0,0,0,0,0,0,0,0,0,0,0,0,0,0},
  {0,0,0,0,0,0,0,0,0,0,0,0,0,0,0,0,0,0,0,0},
  {0,0,0,0,0,0,0,0,0,0,0,0,0,0,0,0,0,0,0,0},
  {0,0,0,0,0,0,0,0,0,0,0,0,0,0,0,0,0,0,0,0},
  {0,0,0,0,0,0,0,0,0,0,0,0,0,0,17,0,0,0,0,0},
  {0,0,0,0,0,0,0,0,0,0,0,0,0,0,0,0,0,0,0,0},
  {0,0,0,0,0,0,0,0,0,0,0,0,0,0,0,0,0,0,0,0},
  {0,0,0,0,0,0,0,0,0,0,0,0,0,0,0,0,0,0,0,0},
  {0,0,0,0,0,0,0,0,0,33,33,33,33,0,0,0,0,0,0,0},
  {0,0,0,0,0,0,0,0,0,33,0,0,0,0,0,0,0,0,0,0},
  {0,0,0,0,18,0,0,0,0,0,0,0,0,0,0,0,0,0,0,0},
  {0,0,0,0,18,0,0,0,0,0,0,0,0,0,0,0,0,0,0,0},
  {0,0,0,0,18,0,0,0,0,0,0,0,0,0,0,0,0,0,0,0},
  {0,19,19,19,0,0,0,0,0,0,0,0,0,0,0,0,0,0,0,0},
  {0,0,0,0,0,0,0,0,0,33,0,0,0,0,0,0,0,0,0,0},
  {0,0,0,0,0,0,0,0,0,33,33,33,33,0,19,0,0,0,0,0},
  {0,0,0,0,0,0,0,0,0,0,0,0,0,0,0,0,0,0,0,0},
  {0,0,0,0,0,0,0,0,0,0,0,0,0,0,0,0,0,0,0,0},
  {0,0,0,0,0,0,0,0,0,0,0,0,0,0,0,0,0,0,0,0},
  {0,0,0,0,0,0,0,0,0,0,0,0,0,0,0,0,0,0,0,0},
  {0,0,0,0,0,0,0,0,0,0,0,0,0,0,0,0,0,0,0,0},
  {0,0,0,0,0,0,0,0,0,0,0,0,0,0,0,0,0,0,0,0},
  {0,0,0,0,0,0,0,0,0,0,0,0,0,0,17,0,0,0,0,0},
  {0,0,0,0,0,0,0,0,0,0,0,0,0,0,0,0,0,0,0,0},
  {0,0,0,0,0,0,0,0,0,0,0,18,33,0,0,0,0,0,0,0},
  {0,0,0,0,0,0,0,0,0,0,0,18,33,0,0,0,0,0,0,0},
  {0,0,0,0,0,0,0,0,0,0,0,18,33,0,0,0,0,0,0,0},
  {0,0,0,0,0,0,0,0,0,0,0,18,33,0,0,0,0,0,0,0},
  {0,0,0,0,0,0,0,0,0,0,0,18,33,0,0,0,0,0,0,0},
  {0,0,0,0,0,0,0,0,0,0,0,18,33,0,0,0,0,0,0,0},
  {0,0,0,0,0,0,0,0,0,0,0,18,33,0,0,0,0,0,0,0},
  {0,0,0,0,0,0,0,0,0,0,0,18,33,0,0,0,0,0,0,0},
  {0,0,0,0,0,0,0,0,0,0,0,18,33,0,0,0,0,0,0,0},
  {0,0,0,0,0,0,0,0,0,0,0,18,33,0,0,0,0,0,0,0},
  {0,0,0,0,0,0,0,0,0,0,0,18,33,0,0,0,0,0,0,0},
  {0,0,0,0,0,0,0,0,0,0,0,18,33,0,0,0,0,0,0,0},
  {0,0,0,0,0,0,0,0,0,0,0,18,33,0,0,0,0,0,0,0},
  {0,0,0,0,0,0,0,0,0,0,0,18,33,0,0,0,0,0,0,0},
  {0,0,0,0,0,0,0,0,0,0,0,0,0,0,0,0,0,0,0,0},
  {0,0,0,0,0,0,0,0,0,0,0,0,0,0,0,0,0,0,0,0},
  {0,0,0,0,0,0,0,0,0,0,0,0,0,0,0,0,0,0,0,0},
  {0,0,0,0,0,0,0,0,0,0,0,0,0,0,0,0,0,0,0,0},
  {0,0,14,0,0,0,0,0,0,0,0,0,0,0,0,0,0,0,0,0},
  {0,0,0,0,0,0,0,0,2,0,0,0,0,0,0,0,0,0,0,0},
  {0,0,0,0,0,0,0,0,0,0,0,0,0,0,0,0,0,0,0,0},
  {0,0,0,0,0,0,0,0,0,0,0,0,0,0,0,0,0,0,0,0}
}
loadWall{
  {0,0,0,0,10,18,18,18,18,18,18,18,18,18,18,18,18,18,18,18},
  {0,0,0,0,10,18,18,18,19,19,19,19,19,18,18,18,18,18,18,18},
  {0,0,0,0,10,18,18,26,0,0,0,0,0,10,18,18,18,18,18,18},
  {0,0,0,0,10,18,18,26,0,0,0,0,0,10,18,18,18,18,18,18},
  {0,0,0,0,10,18,18,26,0,0,0,0,0,10,18,18,18,18,18,18},
  {0,0,0,0,10,18,18,26,0,0,0,0,0,10,18,18,18,18,18,18},
  {0,0,0,0,10,18,18,26,0,0,0,0,0,10,18,18,18,18,18,18},
  {0,0,0,0,11,18,18,26,0,0,0,0,0,10,18,18,18,18,18,18},
  {0,0,0,0,0,10,18,26,0,0,0,0,0,10,18,18,18,18,18,18},
  {0,0,0,0,0,10,18,26,0,0,0,0,0,10,18,18,18,18,18,18},
  {0,0,0,0,0,10,18,26,0,0,0,0,0,10,18,18,18,18,18,18},
  {0,0,0,0,0,11,19,18,17,17,25,0,0,10,18,18,18,18,18,18},
  {0,0,0,0,0,0,0,10,18,18,26,0,0,10,18,18,18,18,18,18},
  {0,0,0,0,0,0,0,11,19,19,27,0,0,10,18,18,18,18,18,18},
  {0,0,0,0,0,0,0,0,0,0,0,0,0,10,18,18,18,18,18,18},
  {0,0,0,0,0,0,0,0,0,0,0,0,0,10,18,18,18,18,18,18},
  {1,0,0,0,0,0,0,0,0,0,0,0,0,10,18,18,18,18,18,18},
  {2,0,0,0,0,0,0,0,0,9,17,17,17,18,18,18,18,18,18,18},
  {10,25,0,0,0,0,0,0,0,0,0,0,19,19,19,18,18,18,18,18},
  {10,26,0,0,0,0,0,0,0,0,0,0,0,0,0,10,18,18,18,18},
  {10,18,25,0,0,0,0,0,0,0,0,0,0,0,0,10,18,18,18,18},
  {10,18,18,17,17,17,25,0,0,0,0,0,0,0,0,10,18,18,18,18},
  {10,18,18,19,19,19,19,0,0,0,0,0,0,0,0,10,18,18,18,18},
  {10,18,26,0,0,0,0,0,0,0,0,0,0,0,0,10,18,18,18,18},
  {10,18,27,0,0,0,0,0,0,0,0,0,0,0,0,10,18,18,18,18},
  {10,26,0,0,0,0,0,0,0,0,0,0,0,0,0,10,18,18,18,18},
  {10,27,0,0,0,0,0,0,0,0,0,0,0,0,0,10,18,18,18,18},
  {2,0,0,0,0,0,0,0,0,0,0,0,0,0,0,10,18,18,18,18},
  {2,0,0,0,0,0,0,0,0,0,0,0,0,0,0,10,18,18,18,18},
  {2,0,0,0,0,0,0,0,0,0,0,0,0,0,0,10,18,18,18,18},
  {2,0,0,0,0,12,17,0,0,0,0,0,0,0,0,10,18,18,18,18},
  {2,0,0,0,0,0,2,0,0,0,0,0,0,0,0,10,18,18,18,18},
  {2,0,0,0,0,0,2,0,0,0,0,0,0,0,0,10,18,18,18,18},
  {2,0,0,0,0,0,3,0,0,0,0,0,0,0,0,10,18,18,18,18},
  {2,0,0,0,0,0,0,0,1,0,0,0,0,0,0,10,18,18,18,18},
  {2,0,0,0,0,0,0,0,2,0,0,0,0,0,0,10,18,18,18,18},
  {2,0,0,0,0,0,0,0,2,0,0,0,0,12,20,18,18,18,18,18},
  {2,0,0,0,0,0,0,0,3,0,0,0,0,0,0,10,18,18,18,18},
  {2,0,0,0,0,0,0,0,0,0,0,0,0,0,0,10,18,18,18,18},
  {2,0,0,0,0,0,0,0,0,0,0,0,0,25,0,10,18,18,18,18},
  {2,0,0,0,0,0,0,0,0,0,18,18,18,26,0,10,18,18,18,18},
  {2,0,0,0,0,0,0,0,0,10,18,18,18,26,0,10,18,18,18,18},
  {2,0,0,0,0,0,0,0,0,10,18,18,18,26,0,10,18,18,18,18},
  {2,0,0,0,0,0,0,0,0,10,18,18,18,26,0,10,18,18,18,18},
  {3,0,0,0,1,0,0,0,0,10,18,18,18,26,0,10,18,18,18,18},
  {0,0,0,0,2,0,0,0,0,0,18,18,18,26,0,10,18,18,18,18},
  {0,0,0,0,2,0,0,0,0,0,0,0,0,27,0,10,18,18,18,18},
  {0,0,0,0,2,0,0,0,0,0,0,0,0,0,0,10,18,18,18,18},
  {0,0,0,0,2,0,0,0,0,0,0,0,0,0,0,10,18,18,18,18},
  {0,0,0,0,2,0,0,0,0,0,0,0,0,0,0,10,18,18,18,18},
  {0,0,0,0,11,20,20,20,20,20,20,20,20,20,20,18,18,18,18,18},
  {0,0,0,0,0,0,0,0,0,0,0,0,0,0,0,10,18,18,18,18},
  {0,0,0,0,0,0,0,0,0,0,0,0,0,0,0,10,18,18,18,18},
  {9,17,17,17,17,17,17,25,0,0,0,9,25,0,0,10,18,18,18,18},
  {10,18,18,18,18,18,18,26,0,0,0,11,26,0,0,10,18,18,18,18},
  {10,18,18,18,18,18,18,26,0,0,0,0,0,17,17,18,18,18,18,18},
  {10,18,18,18,18,18,18,18,25,0,0,0,0,18,18,18,18,18,18,18},
  {10,18,18,18,18,18,18,18,26,0,0,0,0,18,18,18,18,18,18,18},
  {10,18,18,18,18,18,18,18,26,0,0,0,0,18,18,18,18,18,18,18},
  {10,18,18,18,18,18,18,18,26,0,0,0,0,18,18,18,18,18,18,18},
  {10,18,18,18,18,18,18,18,26,0,0,0,0,18,18,18,18,18,18,18},
  {10,18,18,18,18,18,18,18,26,0,0,0,0,18,18,18,18,18,18,18},
  {10,18,18,18,18,18,18,18,26,0,0,0,0,18,18,18,18,18,18,18},
  {10,18,18,18,18,18,18,18,26,0,0,0,0,18,18,18,18,18,18,18},
  {10,18,18,18,18,18,18,18,26,0,0,0,0,18,18,18,18,18,18,18},
  {10,18,18,18,18,18,18,18,26,0,0,0,0,18,18,18,18,18,18,18},
  {10,18,18,18,18,18,18,18,26,0,0,0,0,18,18,18,18,18,18,18},
  {10,18,18,18,18,18,18,18,26,0,0,0,0,18,18,18,18,18,18,18},
  {10,18,18,18,18,18,18,18,27,0,0,0,0,18,18,18,18,18,18,18},
  {10,18,18,18,18,18,18,26,0,0,0,9,18,18,18,18,18,18,18,18},
  {10,18,18,18,18,18,19,27,0,0,0,10,18,18,18,18,18,18,18,18},
  {11,19,19,18,18,26,0,0,0,0,0,10,18,18,18,18,18,18,18,18},
  {0,0,0,10,18,26,0,0,0,9,17,18,18,18,18,18,18,18,18,18},
  {0,0,0,10,18,26,0,0,0,10,18,18,18,18,18,18,18,18,18,18},
  {0,0,0,10,18,26,0,0,0,10,18,18,18,18,18,18,18,18,18,18},
  {9,17,17,18,18,26,0,0,0,10,18,18,18,18,18,18,18,18,18,18},
  {10,18,18,18,18,18,17,17,17,18,18,18,18,18,18,18,18,18,18,18}
}
loadCollision{
  {0,0,0,0,1,1,1,1,1,1,1,1,1,1,1,1,1,1,1,1},
  {0,0,0,0,1,1,1,1,1,1,1,1,1,1,1,1,1,1,1,1},
  {0,0,0,0,1,1,1,1,0,0,0,0,0,1,1,1,1,1,1,1},
  {0,0,0,0,1,1,1,1,0,0,0,0,0,1,1,1,1,1,1,1},
  {0,0,0,0,1,1,1,1,0,0,0,0,0,1,1,1,1,1,1,1},
  {0,0,0,0,1,1,1,1,0,0,0,0,0,1,1,1,1,1,1,1},
  {0,0,0,0,1,1,1,1,0,0,0,0,0,1,1,1,1,1,1,1},
  {0,0,0,0,1,1,1,1,0,0,0,0,0,1,1,1,1,1,1,1},
  {0,0,0,0,0,1,1,1,0,0,0,0,0,1,1,1,1,1,1,1},
  {0,0,0,0,0,1,1,1,0,0,0,0,0,1,1,1,1,1,1,1},
  {0,0,0,0,0,1,1,1,0,0,0,0,0,1,1,1,1,1,1,1},
  {0,0,0,0,0,1,1,1,1,1,1,0,0,1,1,1,1,1,1,1},
  {0,0,0,0,0,0,0,1,1,1,1,1,1,1,1,1,1,1,1,1},
  {0,0,0,0,0,0,0,1,1,1,1,0,0,1,1,1,1,1,1,1},
  {0,0,0,0,0,0,0,0,0,0,0,0,0,1,1,1,1,1,1,1},
  {0,0,0,0,0,0,0,0,0,0,0,0,0,1,1,1,1,1,1,1},
  {1,0,0,0,0,0,0,0,0,0,0,0,0,1,1,1,1,1,1,1},
  {1,0,0,0,0,0,0,0,0,1,1,1,1,1,1,1,1,1,1,1},
  {1,1,0,0,0,0,0,0,0,3,3,3,1,1,1,1,1,1,1,1},
  {1,1,0,0,0,0,0,0,0,0,0,0,0,0,0,1,1,1,1,1},
  {1,1,1,0,0,0,0,0,0,0,0,0,0,0,0,1,1,1,1,1},
  {1,1,1,1,1,1,1,0,0,0,0,0,0,0,0,1,1,1,1,1},
  {1,1,1,1,1,1,1,3,3,3,3,3,0,0,0,1,1,1,1,1},
  {1,1,1,0,0,0,0,0,0,0,0,0,0,0,0,1,1,1,1,1},
  {1,1,1,0,0,0,0,0,0,0,0,0,0,0,0,1,1,1,1,1},
  {1,1,0,0,0,0,0,0,0,0,0,0,0,0,0,1,1,1,1,1},
  {1,1,0,0,0,0,0,0,0,0,0,0,0,0,0,1,1,1,1,1},
  {1,0,0,0,0,0,0,0,0,0,0,0,0,0,0,1,1,1,1,1},
  {1,0,0,0,0,0,0,0,0,0,0,0,0,0,0,1,1,1,1,1},
  {1,0,0,0,0,0,0,0,0,0,0,0,0,0,0,1,1,1,1,1},
  {1,0,0,0,0,1,1,3,3,3,3,3,0,0,0,1,1,1,1,1},
  {1,0,0,0,0,0,1,0,0,0,0,0,0,0,0,1,1,1,1,1},
  {1,0,0,0,0,0,1,0,0,0,0,0,0,0,0,1,1,1,1,1},
  {1,0,0,0,0,0,1,0,0,0,0,0,0,0,0,1,1,1,1,1},
  {1,0,0,0,0,0,0,0,1,0,0,0,0,0,0,1,1,1,1,1},
  {1,0,0,0,0,0,0,0,1,0,0,0,0,0,0,1,1,1,1,1},
  {1,0,0,0,0,0,0,0,1,0,0,0,0,1,1,1,1,1,1,1},
  {1,0,0,0,0,0,0,0,1,0,0,0,0,0,0,1,1,1,1,1},
  {1,0,0,0,0,0,0,0,0,0,0,0,0,0,0,1,1,1,1,1},
  {1,0,0,0,0,0,0,0,0,3,3,3,3,1,0,1,1,1,1,1},
  {1,0,0,0,0,0,0,0,0,3,1,1,1,1,0,1,1,1,1,1},
  {1,0,0,0,0,0,0,0,0,1,1,1,1,1,0,1,1,1,1,1},
  {1,0,0,0,0,0,0,0,0,1,1,1,1,1,0,1,1,1,1,1},
  {1,0,0,0,0,0,0,0,0,1,1,1,1,1,0,1,1,1,1,1},
  {1,1,1,1,1,0,0,0,0,1,1,1,1,1,0,1,1,1,1,1},
  {0,0,0,0,1,0,0,0,0,3,1,1,1,1,0,1,1,1,1,1},
  {0,0,0,0,1,0,0,0,0,3,3,3,3,1,1,1,1,1,1,1},
  {0,0,0,0,1,0,0,0,0,0,0,0,0,0,0,1,1,1,1,1},
  {0,0,0,0,1,0,0,0,0,0,0,0,0,0,0,1,1,1,1,1},
  {0,0,0,0,1,0,0,0,0,0,0,0,0,0,0,1,1,1,1,1},
  {0,0,0,0,1,1,1,1,1,1,1,1,1,1,1,1,1,1,1,1},
  {0,0,0,0,0,0,0,0,0,0,0,0,0,0,0,1,1,1,1,1},
  {0,0,0,0,0,0,0,0,0,0,0,0,0,0,0,1,1,1,1,1},
  {1,1,1,1,1,1,1,1,0,0,0,1,1,0,0,1,1,1,1,1},
  {1,1,1,1,1,1,1,1,0,0,0,1,1,0,0,1,1,1,1,1},
  {1,1,1,1,1,1,1,1,0,0,0,0,3,1,1,1,1,1,1,1},
  {1,1,1,1,1,1,1,1,1,0,0,0,3,1,1,1,1,1,1,1},
  {1,1,1,1,1,1,1,1,1,0,0,0,3,1,1,1,1,1,1,1},
  {1,1,1,1,1,1,1,1,1,0,0,0,3,1,1,1,1,1,1,1},
  {1,1,1,1,1,1,1,1,1,0,0,0,3,1,1,1,1,1,1,1},
  {1,1,1,1,1,1,1,1,1,0,0,0,3,1,1,1,1,1,1,1},
  {1,1,1,1,1,1,1,1,1,0,0,0,3,1,1,1,1,1,1,1},
  {1,1,1,1,1,1,1,1,1,0,0,0,3,1,1,1,1,1,1,1},
  {1,1,1,1,1,1,1,1,1,0,0,0,3,1,1,1,1,1,1,1},
  {1,1,1,1,1,1,1,1,1,0,0,0,3,1,1,1,1,1,1,1},
  {1,1,1,1,1,1,1,1,1,0,0,0,3,1,1,1,1,1,1,1},
  {1,1,1,1,1,1,1,1,1,0,0,0,3,1,1,1,1,1,1,1},
  {1,1,1,1,1,1,1,1,1,0,0,0,3,1,1,1,1,1,1,1},
  {1,1,1,1,1,1,1,1,1,0,0,0,3,1,1,1,1,1,1,1},
  {1,1,1,1,1,1,1,1,0,0,0,1,1,1,1,1,1,1,1,1},
  {1,1,1,1,1,1,1,1,0,0,0,1,1,1,1,1,1,1,1,1},
  {1,1,1,1,1,1,0,0,0,0,0,1,1,1,1,1,1,1,1,1},
  {0,0,0,1,1,1,0,0,0,1,1,1,1,1,1,1,1,1,1,1},
  {0,0,0,1,1,1,0,0,0,1,1,1,1,1,1,1,1,1,1,1},
  {0,0,0,1,1,1,0,0,0,1,1,1,1,1,1,1,1,1,1,1},
  {1,1,1,1,1,1,0,0,0,1,1,1,1,1,1,1,1,1,1,1},
  {1,1,1,1,1,1,1,1,1,1,1,1,1,1,1,1,1,1,1,1}
}
