mapSize(32, 20)
start{x=9,y=18}
loadBG{
  {0,0,0,0,0,0,0,0,0,0,0,0,0,0,0,0,0,0,0,0},
  {0,0,0,0,0,0,0,0,0,0,0,0,0,0,0,0,0,0,0,0},
  {0,0,0,0,0,0,0,0,0,0,0,0,0,0,0,0,0,0,0,0},
  {0,0,0,0,0,0,0,0,0,0,0,0,0,0,0,0,0,0,0,0},
  {0,0,0,0,0,0,0,0,0,0,0,0,0,0,0,0,0,0,0,0},
  {0,0,0,0,0,0,0,0,0,0,0,0,0,0,0,0,0,0,0,0},
  {0,0,0,0,0,0,0,0,0,0,0,0,0,0,0,0,0,0,0,0},
  {0,0,0,0,0,0,0,0,0,0,0,0,0,0,0,0,0,0,0,0},
  {0,0,0,0,0,0,0,0,0,0,0,0,0,0,0,68,76,84,0,0},
  {0,0,0,0,0,0,0,0,0,0,0,0,0,0,0,69,77,85,0,0},
  {0,0,0,0,0,0,0,0,0,0,0,0,0,0,62,70,78,86,0,0},
  {0,0,0,0,0,0,0,0,0,0,0,0,0,0,0,71,79,87,0,0},
  {0,0,0,0,0,0,0,0,0,0,0,0,0,0,0,72,80,88,0,0},
  {0,0,0,0,0,0,0,0,0,0,0,0,0,0,0,0,0,0,0,0},
  {0,0,0,0,0,0,0,0,0,0,0,0,0,0,0,0,0,0,0,0},
  {0,0,0,0,0,0,0,0,0,0,0,0,0,0,0,0,0,0,0,0},
  {0,0,0,0,0,0,0,0,0,0,0,0,0,0,0,0,0,0,0,0},
  {0,0,0,0,0,0,0,0,0,0,0,0,0,0,0,0,0,0,0,0},
  {0,0,0,0,0,0,0,0,0,0,0,0,0,0,0,0,0,0,0,0},
  {0,0,0,0,0,0,0,0,0,0,0,0,0,0,0,0,0,0,0,0},
  {0,0,0,0,0,0,0,0,0,0,0,0,0,0,0,0,0,0,0,0},
  {0,0,0,0,0,0,0,0,0,0,0,0,0,0,0,0,0,0,0,0},
  {0,0,0,0,0,0,0,0,0,0,0,0,0,0,0,0,0,0,0,0},
  {0,0,0,0,0,0,0,0,0,0,0,0,0,0,0,0,0,0,0,0},
  {0,0,0,81,89,97,105,0,0,0,0,0,0,0,0,0,0,0,0,0},
  {0,0,0,82,90,98,106,0,0,0,0,0,0,0,0,0,0,0,0,0},
  {0,0,0,83,91,99,107,1,9,9,9,9,9,9,9,9,9,9,9,9},
  {0,0,0,0,92,100,108,2,10,10,10,10,10,10,10,10,10,10,10,10},
  {0,0,0,0,93,0,0,2,10,10,10,10,10,10,10,10,10,10,10,10},
  {0,0,0,0,0,0,0,2,10,10,10,10,10,10,10,10,10,10,10,10},
  {0,0,0,0,0,0,0,2,10,10,10,10,10,10,10,10,10,10,10,10},
  {0,0,0,0,0,0,0,2,10,10,10,10,10,10,10,10,10,10,10,10}
}
loadFG{
  {0,0,0,0,0,0,0,0,0,0,0,0,0,0,0,0,0,0,0,0},
  {0,0,0,0,0,0,0,0,0,0,0,0,0,0,0,0,0,0,0,0},
  {0,0,0,0,0,0,0,0,0,0,0,0,0,0,0,0,0,0,0,0},
  {0,0,0,0,0,0,0,0,0,0,0,0,0,0,0,0,0,0,0,0},
  {0,0,0,0,0,0,0,0,0,0,0,0,0,0,0,0,0,0,0,0},
  {0,0,0,0,0,0,0,0,0,0,0,0,0,0,0,0,0,0,0,0},
  {0,0,0,0,0,0,0,0,0,0,0,0,0,0,0,0,0,0,0,0},
  {0,0,0,0,0,0,0,0,0,0,0,0,0,0,0,0,0,0,0,0},
  {0,0,0,0,0,0,0,0,0,0,0,0,0,0,0,0,0,0,0,0},
  {0,0,0,0,0,0,0,0,0,0,0,0,0,0,0,0,0,0,0,0},
  {0,0,0,0,0,0,0,0,0,0,0,0,0,0,0,0,0,0,0,0},
  {0,0,0,0,0,0,0,0,0,0,0,0,0,0,0,0,0,0,0,0},
  {0,0,0,0,0,0,0,0,0,0,0,0,0,0,0,0,0,0,0,0},
  {0,0,0,0,0,0,0,0,0,0,0,0,0,0,0,0,0,0,0,0},
  {0,0,0,0,0,0,0,0,0,0,0,0,0,0,0,0,0,0,0,0},
  {0,0,0,0,0,0,0,0,0,0,0,0,0,0,0,0,0,0,0,0},
  {0,0,0,0,0,0,0,0,0,0,0,0,0,0,0,0,0,0,0,0},
  {0,0,0,0,0,0,0,0,0,0,0,0,0,0,0,0,0,0,0,0},
  {0,0,0,0,0,0,0,0,0,0,0,0,0,0,0,0,0,0,0,0},
  {0,0,0,0,0,0,0,0,0,0,0,0,0,0,0,0,0,0,0,0},
  {0,0,0,0,0,0,0,0,0,0,0,0,0,0,0,0,0,0,0,0},
  {0,0,0,0,0,0,0,0,0,0,0,0,0,0,0,0,0,0,0,0},
  {0,0,0,0,0,0,0,0,0,0,0,0,0,0,0,0,0,0,0,0},
  {0,0,0,0,0,0,0,0,0,0,0,0,0,0,0,0,0,0,0,0},
  {0,0,0,0,0,0,0,0,0,0,0,0,0,0,0,0,0,0,0,0},
  {0,0,0,0,0,0,0,0,0,0,0,0,0,0,0,0,0,0,0,0},
  {0,0,0,0,0,0,0,0,0,0,0,0,0,0,0,0,0,0,0,0},
  {0,0,0,0,0,0,0,0,0,0,0,0,0,0,0,0,0,0,0,0},
  {0,0,0,0,0,0,0,0,0,0,0,0,0,0,0,0,0,0,0,0},
  {0,0,0,0,0,0,0,0,0,0,0,0,0,0,0,0,0,0,0,0},
  {0,0,0,0,0,0,0,0,0,0,0,0,0,0,0,0,0,0,0,0},
  {0,0,0,0,0,0,0,0,0,0,0,0,0,0,0,0,0,0,0,0}
}
loadOBJ{
  {0,0,0,0,0,0,0,0,0,0,0,0,0,0,0,0,0,0,0,0},
  {0,0,0,0,0,0,0,0,0,0,0,0,0,0,0,0,0,0,0,0},
  {0,0,0,0,0,0,0,0,0,0,0,0,0,0,0,0,0,0,0,0},
  {0,0,0,0,0,0,0,0,0,0,0,0,0,0,0,0,0,0,0,0},
  {0,0,0,0,0,0,2,0,0,0,0,0,0,0,0,0,0,0,0,0},
  {0,0,0,0,0,0,0,0,0,0,0,0,0,0,0,0,0,0,0,0},
  {0,0,0,0,0,0,0,0,0,0,0,0,0,0,0,0,0,0,0,0},
  {0,0,0,0,0,0,0,0,0,0,0,0,0,0,0,0,0,0,0,0},
  {0,0,0,0,0,0,0,0,0,0,0,0,0,0,0,0,0,0,0,0},
  {0,0,0,0,0,0,0,0,0,0,0,0,0,0,0,0,0,0,0,0},
  {0,0,0,75,0,0,0,0,0,0,0,0,0,0,0,0,0,0,0,0},
  {0,0,0,75,0,0,0,0,0,0,0,0,0,0,0,0,0,0,0,0},
  {0,0,0,75,0,0,0,0,0,0,0,0,0,0,0,0,0,0,0,0},
  {0,0,0,75,0,0,0,0,0,0,0,0,0,0,0,0,0,0,0,0},
  {0,0,0,0,0,0,0,0,0,0,0,0,0,0,0,0,0,0,0,0},
  {0,0,0,0,0,0,0,0,0,0,0,0,0,0,0,0,0,0,0,0},
  {0,0,0,0,0,0,0,0,0,0,0,0,0,0,0,0,0,0,0,0},
  {0,0,0,0,0,0,73,0,0,0,0,0,0,0,0,0,73,0,0,0},
  {0,0,0,0,0,0,73,0,0,0,0,0,0,0,0,0,73,0,0,0},
  {0,0,0,0,0,0,73,0,0,0,0,0,0,0,0,0,73,0,0,0},
  {0,0,0,0,0,0,73,0,0,0,0,0,0,0,0,0,73,0,0,0},
  {0,0,0,0,0,0,0,0,0,0,0,0,0,0,0,0,0,0,0,0},
  {0,0,0,0,0,0,0,0,0,0,0,0,0,0,0,0,0,0,0,0},
  {0,0,0,0,0,0,0,0,0,0,0,0,0,0,0,0,0,0,0,0},
  {0,0,0,0,0,0,0,0,0,0,0,0,0,0,0,0,0,0,0,0},
  {0,0,0,0,0,0,0,0,0,0,0,0,0,0,0,0,0,0,0,0},
  {0,0,0,0,0,0,0,0,0,0,0,0,0,0,0,0,0,0,0,0},
  {0,0,0,0,0,0,0,0,0,0,0,0,0,0,74,0,0,0,0,0},
  {0,0,0,0,0,0,0,0,76,76,0,0,0,0,0,0,0,0,0,0},
  {0,0,0,0,0,0,0,0,0,0,0,0,0,0,0,0,0,0,0,0},
  {0,0,0,0,0,0,0,0,0,0,0,0,0,0,0,0,0,0,0,0},
  {0,0,0,0,0,0,0,0,0,0,0,0,0,0,0,0,0,0,0,0}
}
loadWall{
  {0,0,0,0,0,0,0,0,0,0,0,0,0,0,0,0,0,0,0,0},
  {0,0,0,0,0,0,9,25,0,0,0,0,0,0,0,0,0,0,0,0},
  {0,0,0,0,0,0,11,18,25,0,0,0,0,0,0,0,0,0,0,0},
  {0,0,0,0,0,0,0,10,26,0,0,0,0,0,0,0,0,0,0,0},
  {0,0,0,0,0,0,0,10,26,0,0,0,0,0,0,0,0,0,0,0},
  {0,0,0,0,0,0,0,11,27,0,0,0,0,0,0,0,0,0,0,0},
  {0,0,0,0,0,0,0,0,0,0,0,0,0,0,0,0,0,0,0,0},
  {0,0,0,0,0,0,0,0,0,0,0,0,0,0,0,0,0,0,9,25},
  {0,0,0,0,0,0,0,0,0,0,0,0,0,0,0,0,0,0,10,26},
  {0,0,0,0,0,0,0,0,0,0,0,0,0,0,0,0,0,0,10,26},
  {0,0,1,0,0,0,0,1,0,0,0,0,0,0,0,0,0,0,10,26},
  {0,0,2,0,0,0,0,2,0,0,0,0,0,0,0,0,0,0,10,26},
  {0,0,2,0,0,0,0,2,0,0,0,0,0,0,0,0,0,0,11,27},
  {0,0,3,0,0,0,0,3,0,0,0,0,0,0,0,0,0,0,0,0},
  {0,0,0,0,0,0,0,0,0,0,0,0,0,0,0,0,0,0,0,0},
  {0,0,0,0,0,0,0,0,0,0,0,0,0,0,0,0,0,0,0,0},
  {0,0,0,0,0,0,0,0,0,0,0,0,0,0,0,0,0,0,0,0},
  {0,0,1,0,0,0,0,1,0,0,0,1,0,0,0,0,0,1,0,0},
  {0,0,2,0,0,0,0,10,17,17,17,26,0,0,0,0,0,2,0,0},
  {0,0,2,0,0,0,0,10,19,19,19,26,0,0,0,0,0,2,0,0},
  {0,0,3,0,0,0,0,3,0,0,0,3,0,0,0,0,0,3,0,0},
  {0,0,0,0,0,0,0,0,0,0,0,0,0,0,0,0,0,0,0,0},
  {0,0,0,0,0,0,0,0,0,0,0,0,0,0,0,0,0,0,0,0},
  {0,0,0,0,0,0,0,0,0,0,0,0,0,0,0,0,0,0,0,0},
  {0,0,0,0,0,0,0,1,0,0,0,0,0,0,0,0,0,0,0,0},
  {0,0,0,0,0,0,0,2,0,0,0,0,0,0,0,0,0,0,0,9},
  {0,0,0,0,0,0,0,11,20,20,20,20,20,20,20,20,28,0,0,10},
  {0,0,0,0,0,0,0,0,0,0,0,0,0,0,0,0,0,0,0,10},
  {0,0,0,0,0,0,0,0,0,0,0,0,0,0,0,0,0,0,0,10},
  {0,0,0,0,0,0,0,0,0,0,0,0,0,0,0,0,0,0,0,10},
  {0,0,0,0,0,0,0,9,17,17,17,17,17,17,17,17,17,17,17,18},
  {0,0,0,0,0,9,17,18,18,18,18,18,18,18,18,18,18,18,18,18}
}
loadCollision{
  {0,0,0,0,0,0,0,0,0,0,0,0,0,0,0,0,0,0,0,0},
  {0,0,0,0,0,0,1,1,0,0,0,0,0,0,0,0,0,0,0,0},
  {0,0,0,0,0,0,1,1,1,0,0,0,0,0,0,0,0,0,0,0},
  {0,0,0,0,0,0,0,1,1,0,0,0,0,0,0,0,0,0,0,0},
  {0,0,0,0,0,0,0,1,1,0,0,0,0,0,0,0,0,0,0,0},
  {0,0,0,0,0,0,0,1,1,0,0,0,0,0,0,0,0,0,0,0},
  {0,0,0,0,0,0,0,0,0,0,0,0,0,0,0,0,0,0,0,0},
  {0,0,0,0,0,0,0,0,0,0,0,0,0,0,0,0,0,0,1,1},
  {0,0,0,0,0,0,0,0,0,0,0,0,0,0,0,0,0,0,1,1},
  {0,0,0,0,0,0,0,0,0,0,0,0,0,0,0,0,0,0,1,1},
  {0,0,1,0,0,0,0,1,0,0,0,0,0,0,0,0,0,0,1,1},
  {0,0,1,0,0,0,0,1,0,0,0,0,0,0,0,0,0,0,1,1},
  {0,0,1,0,0,0,0,1,0,0,0,0,0,0,0,0,0,0,1,1},
  {0,0,1,0,0,0,0,1,0,0,0,0,0,0,0,0,0,0,0,0},
  {0,0,0,0,0,0,0,0,0,0,0,0,0,0,0,0,0,0,0,0},
  {0,0,0,0,0,0,0,0,0,0,0,0,0,0,0,0,0,0,0,0},
  {0,0,0,0,0,0,0,0,0,0,0,0,0,0,0,0,0,0,0,0},
  {0,0,1,0,0,0,0,1,0,0,0,1,0,0,0,0,0,1,0,0},
  {0,0,1,0,0,0,0,1,1,1,1,1,0,0,0,0,0,1,0,0},
  {0,0,1,0,0,0,0,1,1,1,1,1,0,0,0,0,0,1,0,0},
  {0,0,1,0,0,0,0,1,0,0,0,1,0,0,0,0,0,1,0,0},
  {0,0,0,0,0,0,0,0,0,0,0,0,0,0,0,0,0,0,0,0},
  {0,0,0,0,0,0,0,0,0,0,0,0,0,0,0,0,0,0,0,0},
  {0,0,0,0,0,0,0,0,0,0,0,0,0,0,0,0,0,0,0,0},
  {0,0,0,0,0,0,0,1,0,0,0,0,0,0,0,0,0,0,0,0},
  {0,0,0,0,0,0,0,1,0,0,0,0,0,0,0,0,0,0,0,1},
  {0,0,0,0,0,0,0,1,1,1,1,1,1,1,1,1,1,0,0,1},
  {0,0,0,0,0,0,0,0,0,0,0,0,0,0,0,0,0,0,0,1},
  {0,0,0,0,0,0,0,0,0,0,0,0,0,0,0,0,0,0,0,1},
  {0,0,0,0,0,0,0,0,0,0,0,0,0,0,0,0,0,0,0,1},
  {0,0,0,0,0,0,0,1,1,1,1,1,1,1,1,1,1,1,1,1},
  {0,0,0,0,0,1,1,1,1,1,1,1,1,1,1,1,1,1,1,1}
}
