mapSize(43, 20)
start{x=9,y=13}
loadBG{
  {0,0,0,0,0,0,0,0,0,0,0,0,0,0,0,0,0,0,0,0},
  {0,0,0,0,0,0,0,0,0,0,0,0,0,0,0,0,0,0,0,0},
  {0,0,0,0,0,0,0,0,0,0,0,0,21,0,0,0,0,0,0,0},
  {0,0,0,0,0,0,0,0,0,0,0,14,22,0,0,0,0,0,0,0},
  {0,0,0,0,0,0,0,0,0,0,0,0,0,0,0,0,0,0,0,0},
  {0,0,0,0,0,0,0,0,0,0,0,0,0,0,0,0,0,0,0,0},
  {0,0,0,0,0,0,0,0,0,0,0,0,0,0,0,0,0,0,0,0},
  {0,0,0,0,0,0,0,0,0,0,0,0,0,0,0,0,0,0,0,0},
  {0,0,0,0,0,0,0,0,0,0,0,0,0,0,0,0,0,0,0,0},
  {0,0,0,0,0,0,0,0,0,0,0,101,109,0,0,0,0,0,0,0},
  {0,0,0,0,0,0,0,0,0,0,94,102,110,0,0,0,0,0,0,0},
  {0,0,0,0,0,0,0,0,0,0,95,103,111,0,0,0,0,0,0,0},
  {0,0,0,0,0,0,0,0,0,0,96,104,112,0,0,0,0,0,0,0},
  {0,0,0,0,0,0,0,0,0,0,0,0,0,0,0,0,0,0,0,0},
  {0,0,0,0,0,0,0,0,0,0,0,0,0,0,0,0,0,0,0,0},
  {0,0,0,0,0,0,0,0,0,0,0,0,0,0,0,0,0,0,0,0},
  {0,0,0,0,0,0,0,0,0,0,0,0,0,0,0,0,0,0,0,0},
  {0,0,0,0,0,0,0,0,0,0,0,0,0,0,0,0,0,0,0,0},
  {0,0,0,0,0,0,0,0,0,0,0,0,0,0,0,0,0,0,0,0},
  {0,0,0,0,0,0,0,0,0,0,0,0,0,0,0,0,0,0,0,0},
  {0,0,0,0,0,0,0,0,0,0,0,0,0,0,0,0,0,0,0,0},
  {0,0,0,0,0,0,0,0,0,0,0,0,0,0,0,0,0,0,0,0},
  {0,0,0,0,0,0,0,0,0,0,0,0,0,0,0,0,0,0,0,0},
  {0,0,0,0,0,0,0,0,0,0,0,0,0,0,0,0,0,0,0,0},
  {0,0,0,0,0,0,0,0,0,0,0,0,0,0,0,0,0,0,0,0},
  {0,0,0,0,0,0,0,0,0,0,0,0,0,0,0,0,0,0,0,0},
  {0,0,0,0,0,0,0,0,0,0,0,0,0,0,0,0,0,0,0,0},
  {0,0,0,0,0,0,0,0,0,0,0,0,0,0,0,0,0,0,0,0},
  {0,0,0,0,0,0,0,0,0,0,0,0,0,0,0,0,0,0,0,0},
  {0,0,0,0,0,0,0,0,0,0,0,0,0,0,0,0,0,0,0,0},
  {0,0,0,0,0,0,0,0,0,0,0,0,0,0,0,0,0,0,0,0},
  {0,0,0,0,0,0,0,0,0,0,0,0,0,0,0,0,0,0,0,0},
  {0,0,0,0,0,0,0,0,0,0,0,0,0,0,0,0,0,0,0,0},
  {0,0,0,0,0,0,0,0,0,0,0,0,0,0,0,0,0,0,0,0},
  {0,0,0,0,0,0,0,0,0,0,0,0,0,0,0,0,0,0,0,0},
  {0,0,0,0,0,0,0,0,0,0,0,0,0,0,0,0,0,0,0,0},
  {0,0,0,0,0,0,0,0,0,0,0,0,0,0,0,0,0,0,0,0},
  {0,0,0,0,0,0,0,0,0,0,0,0,0,0,0,0,0,0,0,0},
  {0,0,0,0,0,0,0,0,0,0,0,0,0,0,0,0,0,0,0,0},
  {0,0,0,0,0,0,0,0,0,0,0,0,0,0,0,0,0,0,0,0},
  {0,0,0,0,0,0,0,0,0,0,0,0,0,0,0,0,0,0,0,0},
  {0,0,0,0,0,0,0,0,0,0,0,0,0,0,0,0,0,0,0,0},
  {0,0,0,0,0,0,0,0,0,0,0,0,0,0,0,0,0,0,0,0}
}
loadFG{
  {0,0,0,0,0,0,0,0,0,0,0,0,0,0,0,0,0,0,0,0},
  {0,0,0,0,0,0,0,0,0,0,0,0,0,0,0,0,0,0,0,0},
  {0,0,0,0,0,0,0,0,0,0,0,0,0,0,0,0,0,0,0,0},
  {0,0,0,0,0,0,0,0,0,0,0,0,0,0,0,0,0,0,0,0},
  {0,0,0,0,0,0,0,0,0,0,0,0,0,0,0,0,0,0,0,0},
  {0,0,0,0,0,0,0,0,0,0,0,0,0,0,0,0,0,0,0,0},
  {0,0,0,0,0,0,0,0,0,0,0,0,0,0,0,0,0,0,0,0},
  {0,0,0,0,0,0,0,0,0,0,0,0,0,0,0,0,0,0,0,0},
  {0,0,0,0,0,0,0,0,0,0,0,0,0,0,0,0,0,0,0,0},
  {0,0,0,0,0,0,0,0,0,0,0,0,0,0,0,0,0,0,0,0},
  {0,0,0,0,0,0,0,0,0,0,0,0,0,0,0,0,0,0,0,0},
  {0,0,0,0,0,0,0,0,0,0,0,0,0,0,0,0,0,0,0,0},
  {0,0,0,0,0,0,0,0,0,0,0,0,0,0,0,0,0,0,0,0},
  {0,0,0,0,0,0,0,0,0,0,0,0,0,0,0,0,0,0,0,0},
  {0,0,0,0,0,0,0,0,0,0,0,0,0,0,0,42,0,0,0,0},
  {0,0,0,0,0,0,0,0,0,0,0,0,0,0,0,42,0,0,0,0},
  {0,0,0,0,0,0,0,0,0,0,0,0,0,0,0,42,0,0,0,0},
  {0,0,0,0,0,0,0,0,0,0,0,0,0,0,0,42,0,0,0,0},
  {0,0,0,0,0,0,0,0,0,0,0,0,0,0,0,42,0,0,0,0},
  {0,0,0,0,0,0,0,0,0,0,0,0,0,0,0,42,0,0,0,0},
  {0,0,0,0,0,0,0,0,0,0,0,0,0,0,0,42,0,0,0,0},
  {0,0,0,0,0,0,0,0,0,0,0,0,0,0,0,42,0,0,0,0},
  {0,0,0,0,0,0,0,0,0,0,0,0,0,0,0,42,0,0,0,0},
  {0,0,0,0,0,0,0,0,0,0,0,0,0,0,0,42,0,0,0,0},
  {0,0,0,0,0,0,0,0,0,0,0,0,0,0,0,42,0,0,0,0},
  {0,0,0,0,0,0,0,0,0,0,0,0,0,0,0,42,0,0,0,0},
  {0,0,0,0,0,0,0,0,0,0,0,0,0,0,0,42,0,0,0,0},
  {0,0,0,0,0,0,0,0,0,0,0,0,0,0,0,42,0,0,0,0},
  {0,0,0,0,0,0,0,0,0,0,0,0,0,0,0,42,0,0,0,0},
  {0,0,0,0,0,0,0,0,0,0,0,0,0,0,0,42,0,0,0,0},
  {0,0,0,0,0,0,0,0,0,0,0,0,0,0,0,42,0,0,0,0},
  {0,0,0,0,0,0,0,0,0,0,0,0,0,0,0,42,0,0,0,0},
  {0,0,0,0,0,0,0,0,0,0,0,0,0,0,0,42,0,0,0,0},
  {0,0,0,0,0,0,0,0,0,0,0,0,0,0,0,42,0,0,0,0},
  {0,0,0,0,0,0,0,0,0,0,0,0,0,0,0,42,0,0,0,0},
  {0,0,0,0,0,0,0,0,0,0,0,0,0,0,0,42,0,0,0,0},
  {0,0,0,0,0,0,0,0,0,0,0,0,0,0,0,42,0,0,0,0},
  {0,0,0,0,0,0,0,0,0,0,0,0,0,0,0,0,0,0,0,0},
  {0,0,0,0,0,0,0,0,0,0,0,0,0,0,0,0,0,0,0,0},
  {0,0,0,0,0,0,0,0,0,0,0,0,0,0,0,0,0,0,0,0},
  {0,0,0,0,0,0,0,0,0,0,0,0,0,0,0,0,0,0,0,0},
  {0,0,0,0,0,0,0,0,0,0,0,0,0,0,0,0,0,0,0,0},
  {0,0,0,0,0,0,0,0,0,0,0,0,0,0,0,0,0,0,0,0}
}
loadOBJ{
  {0,0,0,0,0,0,0,0,0,0,0,0,0,0,0,0,0,0,0,0},
  {0,0,0,0,0,0,0,0,0,0,0,0,0,0,0,0,0,0,0,0},
  {0,0,0,0,69,0,4,0,0,0,0,0,0,0,0,0,0,0,0,0},
  {0,0,0,0,0,0,0,0,0,0,0,0,0,0,0,0,0,0,0,0},
  {0,0,0,0,0,0,0,0,0,0,0,0,0,0,0,0,0,0,0,0},
  {0,0,0,0,0,0,0,0,0,0,0,0,0,0,0,0,0,0,0,0},
  {0,0,0,0,0,0,0,0,0,0,0,0,0,0,0,0,0,0,0,0},
  {0,0,0,0,0,0,0,0,0,0,0,0,0,0,0,0,0,0,0,0},
  {0,0,0,0,0,0,0,0,0,0,0,0,0,0,0,0,0,0,0,0},
  {0,0,0,0,0,0,0,0,0,0,0,0,0,0,0,0,0,0,0,0},
  {0,0,0,0,0,0,0,0,0,0,0,0,0,0,0,0,0,0,0,0},
  {0,0,0,0,0,0,0,0,0,0,0,0,0,0,0,0,0,0,0,0},
  {0,0,0,0,0,0,0,0,0,0,0,0,0,0,0,0,0,0,0,0},
  {0,0,0,0,0,0,0,0,0,0,0,0,0,0,0,0,0,0,0,0},
  {0,0,0,0,0,0,0,0,0,0,0,0,0,0,0,33,0,0,0,0},
  {0,0,0,0,0,0,0,0,0,0,0,0,0,0,0,33,0,0,0,0},
  {0,0,0,0,0,0,0,0,0,0,0,0,0,0,0,33,0,0,0,0},
  {0,0,0,0,0,0,0,0,0,0,0,0,0,0,0,33,0,0,0,0},
  {0,0,0,0,0,0,0,0,0,0,0,0,0,0,0,33,0,0,0,0},
  {0,0,0,0,0,0,0,0,0,0,0,0,0,0,0,33,0,0,0,0},
  {0,0,0,0,0,0,0,0,0,0,0,0,0,0,0,33,0,0,0,0},
  {0,0,0,0,0,0,0,0,0,0,0,0,0,0,0,33,0,0,0,0},
  {0,0,0,0,0,0,0,0,0,0,0,0,0,0,0,33,0,0,0,0},
  {0,0,0,0,0,0,0,0,0,0,0,0,0,0,0,33,0,0,0,0},
  {0,0,0,0,0,0,0,0,0,0,0,0,0,0,0,33,0,0,0,0},
  {0,0,0,0,0,0,0,0,0,0,0,0,0,0,0,33,0,0,0,0},
  {0,0,0,0,0,0,0,0,0,0,0,0,0,0,0,33,0,0,0,0},
  {0,0,0,0,0,0,0,0,0,0,0,0,0,0,0,33,0,0,0,0},
  {0,0,0,0,0,0,0,0,0,0,0,0,0,0,0,33,0,0,0,0},
  {0,0,0,0,0,0,0,0,0,0,0,0,0,0,0,33,0,0,0,0},
  {0,0,0,0,0,0,0,0,0,0,0,0,0,0,0,33,0,0,0,0},
  {0,0,0,0,0,0,0,0,0,0,0,0,0,0,0,33,0,0,0,0},
  {0,0,0,0,0,0,0,0,0,0,0,0,0,0,0,33,0,0,0,0},
  {0,0,0,0,0,0,0,0,0,0,0,0,0,0,0,33,0,0,0,0},
  {0,0,0,0,0,0,0,0,0,0,0,0,0,0,0,33,0,0,0,0},
  {0,0,0,0,0,0,0,0,0,0,0,0,0,0,0,33,0,0,0,0},
  {0,0,0,0,0,0,0,0,0,0,0,0,0,0,0,33,0,0,0,0},
  {0,0,0,0,0,0,0,0,0,0,0,0,0,0,0,0,0,0,0,0},
  {0,0,0,0,0,0,0,0,0,0,0,0,0,0,0,0,0,0,0,0},
  {0,0,0,0,0,0,0,0,0,0,0,0,2,0,0,0,0,0,0,0},
  {0,0,0,0,0,0,0,0,0,0,0,0,0,0,0,0,0,0,0,0},
  {0,0,0,0,0,0,0,0,0,0,0,0,0,0,0,0,0,0,0,0},
  {0,0,0,0,0,0,0,0,0,0,0,0,0,0,0,0,0,0,0,0}
}
loadWall{
  {0,0,35,43,43,43,43,42,42,42,42,42,42,42,42,42,42,42,42,42},
  {0,0,0,0,0,0,0,34,43,43,43,43,43,42,42,42,42,42,42,42},
  {0,0,0,0,0,0,0,26,0,0,0,0,0,34,42,42,42,42,42,42},
  {0,0,0,0,0,0,0,27,0,0,0,0,0,34,42,42,42,42,42,42},
  {0,0,0,0,0,0,0,0,0,0,89,0,0,34,42,42,42,42,42,42},
  {0,0,0,0,0,0,0,0,0,0,90,0,0,34,42,42,42,42,42,42},
  {0,0,0,0,0,0,0,0,0,0,91,0,0,34,42,42,42,42,42,42},
  {0,0,0,0,0,0,0,0,0,0,0,0,0,34,42,42,42,42,42,42},
  {0,0,0,0,0,0,0,0,0,0,0,0,0,34,42,42,42,42,42,42},
  {0,0,0,0,0,0,0,0,0,0,0,0,0,34,42,42,42,42,42,42},
  {0,0,0,0,0,0,0,0,0,0,0,0,0,34,42,42,42,42,42,42},
  {0,0,0,0,0,0,0,0,0,0,0,0,0,34,42,42,42,42,42,42},
  {0,0,0,0,0,0,0,0,0,0,0,0,0,34,42,42,42,42,42,42},
  {0,0,0,0,0,0,0,0,0,0,0,0,0,35,43,42,42,42,42,42},
  {0,0,0,0,0,0,0,0,0,0,0,0,0,0,0,0,42,42,42,42},
  {0,0,0,0,0,0,0,0,0,0,0,0,0,0,0,0,42,42,42,42},
  {0,0,0,0,0,0,0,0,0,0,0,0,0,0,0,0,42,42,42,42},
  {0,0,0,0,0,0,0,0,0,0,0,0,0,0,0,0,42,42,42,42},
  {0,0,0,0,0,0,0,0,0,0,0,0,0,0,0,0,42,42,42,42},
  {0,0,0,0,0,0,0,0,0,0,0,0,0,0,0,0,42,42,42,42},
  {0,0,0,0,0,0,0,0,0,0,0,0,0,0,0,0,42,42,42,42},
  {0,0,0,0,0,0,0,0,0,0,0,0,0,0,0,0,42,42,42,42},
  {0,0,0,0,0,0,0,0,0,0,0,0,0,0,0,0,42,42,42,42},
  {0,0,0,0,0,0,0,0,0,0,0,0,0,0,0,0,42,42,42,42},
  {0,0,0,0,0,0,0,0,0,0,0,0,0,0,0,0,42,42,42,42},
  {0,0,0,0,0,0,0,0,0,0,0,0,0,0,0,0,42,42,42,42},
  {0,0,0,0,0,0,0,0,0,0,0,0,0,0,0,0,42,42,42,42},
  {0,0,0,0,0,0,0,0,0,0,0,0,0,0,0,0,42,42,42,42},
  {0,0,0,0,0,0,0,0,0,0,0,0,0,0,0,0,42,42,42,42},
  {0,0,0,0,0,0,0,0,0,0,0,0,0,0,0,0,42,42,42,42},
  {0,0,0,0,0,0,0,0,0,0,0,0,0,0,0,0,42,42,42,42},
  {0,0,0,0,0,0,0,0,0,0,0,0,0,0,0,0,42,42,42,42},
  {0,0,0,0,0,0,0,0,0,0,0,0,0,0,0,0,42,42,42,42},
  {0,0,0,0,0,0,0,0,0,0,0,0,0,0,0,0,42,42,42,42},
  {0,0,0,0,0,0,0,0,0,0,0,0,0,0,0,0,42,42,42,42},
  {0,0,0,0,0,0,0,0,0,0,0,0,0,0,0,0,42,42,42,42},
  {0,0,0,0,0,0,0,0,0,0,0,0,0,0,0,0,42,42,42,42},
  {0,0,0,0,0,0,0,0,0,0,0,0,0,33,41,42,42,42,42,42},
  {0,0,0,0,0,0,0,0,0,0,0,0,0,34,42,42,42,42,42,42},
  {0,0,0,0,0,0,0,0,0,0,0,0,0,34,42,42,42,42,42,42},
  {0,0,0,0,0,0,0,0,0,0,0,0,0,34,42,42,42,42,42,42},
  {0,0,0,0,0,0,0,0,0,0,0,33,41,42,42,42,42,42,42,42},
  {0,0,0,0,0,0,0,0,0,0,0,34,42,42,42,42,42,42,42,42}
}
loadCollision{
  {0,0,1,1,1,1,1,1,1,1,1,1,1,1,1,1,1,1,1,1},
  {0,0,0,0,0,0,0,1,1,1,1,1,1,1,1,1,1,1,1,1},
  {0,0,0,0,0,0,0,1,0,0,0,0,0,1,1,1,1,1,1,1},
  {0,0,0,0,0,0,0,1,0,0,0,0,0,1,1,1,1,1,1,1},
  {0,0,0,0,0,0,0,0,0,0,1,0,0,1,1,1,1,1,1,1},
  {0,0,0,0,0,0,0,0,0,0,1,0,0,1,1,1,1,1,1,1},
  {0,0,0,0,0,0,0,0,0,0,1,0,0,1,1,1,1,1,1,1},
  {0,0,0,0,0,0,0,0,0,0,0,0,0,1,1,1,1,1,1,1},
  {0,0,0,0,0,0,0,0,0,0,0,0,0,1,1,1,1,1,1,1},
  {0,0,0,0,0,0,0,0,0,0,0,0,0,1,1,1,1,1,1,1},
  {0,0,0,0,0,0,0,0,0,0,0,0,0,1,1,1,1,1,1,1},
  {0,0,0,0,0,0,0,0,0,0,0,0,0,1,1,1,1,1,1,1},
  {0,0,0,0,0,0,0,0,0,0,0,0,0,1,1,1,1,1,1,1},
  {0,0,0,0,0,0,0,0,0,0,0,0,0,1,1,1,1,1,1,1},
  {0,0,0,0,0,0,0,0,0,0,0,0,0,0,0,3,1,1,1,1},
  {0,0,0,0,0,0,0,0,0,0,0,0,0,0,0,3,1,1,1,1},
  {0,0,0,0,0,0,0,0,0,0,0,0,0,0,0,3,1,1,1,1},
  {0,0,0,0,0,0,0,0,0,0,0,0,0,0,0,3,1,1,1,1},
  {0,0,0,0,0,0,0,0,0,0,0,0,0,0,0,3,1,1,1,1},
  {0,0,0,0,0,0,0,0,0,0,0,0,0,0,0,3,1,1,1,1},
  {0,0,0,0,0,0,0,0,0,0,0,0,0,0,0,3,1,1,1,1},
  {0,0,0,0,0,0,0,0,0,0,0,0,0,0,0,3,1,1,1,1},
  {0,0,0,0,0,0,0,0,0,0,0,0,0,0,0,3,1,1,1,1},
  {0,0,0,0,0,0,0,0,0,0,0,0,0,0,0,3,1,1,1,1},
  {0,0,0,0,0,0,0,0,0,0,0,0,0,0,0,3,1,1,1,1},
  {0,0,0,0,0,0,0,0,0,0,0,0,0,0,0,3,1,1,1,1},
  {0,0,0,0,0,0,0,0,0,0,0,0,0,0,0,3,1,1,1,1},
  {0,0,0,0,0,0,0,0,0,0,0,0,0,0,0,3,1,1,1,1},
  {0,0,0,0,0,0,0,0,0,0,0,0,0,0,0,3,1,1,1,1},
  {0,0,0,0,0,0,0,0,0,0,0,0,0,0,0,3,1,1,1,1},
  {0,0,0,0,0,0,0,0,0,0,0,0,0,0,0,3,1,1,1,1},
  {0,0,0,0,0,0,0,0,0,0,0,0,0,0,0,3,1,1,1,1},
  {0,0,0,0,0,0,0,0,0,0,0,0,0,0,0,3,1,1,1,1},
  {0,0,0,0,0,0,0,0,0,0,0,0,0,0,0,3,1,1,1,1},
  {0,0,0,0,0,0,0,0,0,0,0,0,0,0,0,3,1,1,1,1},
  {0,0,0,0,0,0,0,0,0,0,0,0,0,0,0,3,1,1,1,1},
  {0,0,0,0,0,0,0,0,0,0,0,0,0,0,0,3,1,1,1,1},
  {0,0,0,0,0,0,0,0,0,0,0,0,0,1,1,1,1,1,1,1},
  {0,0,0,0,0,0,0,0,0,0,0,0,0,1,1,1,1,1,1,1},
  {0,0,0,0,0,0,0,0,0,0,0,0,0,1,1,1,1,1,1,1},
  {0,0,0,0,0,0,0,0,0,0,0,0,0,1,1,1,1,1,1,1},
  {0,0,0,0,0,0,0,0,0,0,0,1,1,1,1,1,1,1,1,1},
  {0,0,0,0,0,0,0,0,0,0,0,1,1,1,1,1,1,1,1,1}
}
