mapSize(32, 20)
start{x=5,y=5}
loadBG{
  {0,0,0,0,0,0,0,0,0,0,0,0,0,0,0,0,0,0,0,0},
  {0,0,0,0,0,0,0,0,0,0,0,0,0,0,0,0,0,0,0,0},
  {0,0,0,0,0,0,0,0,0,0,0,0,0,0,0,0,0,0,0,0},
  {0,0,0,0,0,0,0,0,0,0,0,0,0,0,0,0,0,0,0,0},
  {0,0,0,0,0,0,0,0,0,0,0,0,0,0,0,0,0,0,0,0},
  {0,0,0,0,0,0,0,0,0,0,0,0,0,0,0,0,0,0,0,0},
  {0,0,0,0,0,0,0,0,0,0,0,0,0,0,0,0,0,0,0,0},
  {0,0,0,0,0,0,0,0,0,0,0,0,0,0,0,0,0,0,0,0},
  {0,0,0,0,0,0,0,0,0,0,0,0,0,0,0,0,0,0,0,0},
  {0,0,0,0,0,0,0,0,0,0,0,0,0,0,0,0,0,0,0,0},
  {0,0,0,0,0,0,0,0,0,0,0,0,0,0,0,0,0,0,0,0},
  {0,0,0,0,0,0,0,0,0,0,0,0,0,0,0,0,0,0,0,0},
  {0,0,0,0,0,0,0,0,0,0,0,0,0,0,0,0,0,0,0,0},
  {0,0,0,0,0,0,0,0,0,0,0,0,0,0,0,0,0,0,0,0},
  {0,0,0,0,0,0,0,0,0,0,0,0,0,0,0,0,0,0,0,0},
  {0,0,0,0,0,0,0,0,0,0,0,0,0,0,0,0,0,0,0,0},
  {0,0,0,0,0,0,0,0,0,0,0,0,0,0,0,0,0,0,0,0},
  {0,0,0,0,0,0,0,0,0,0,0,0,0,0,0,0,0,0,0,0},
  {0,0,0,0,0,0,0,0,0,0,0,0,0,0,0,0,0,0,0,0},
  {0,0,0,0,0,0,0,0,0,0,0,0,0,0,0,0,0,0,0,0},
  {0,0,0,0,0,0,0,0,0,0,0,0,0,0,0,0,0,0,0,0},
  {0,0,0,0,0,0,0,0,0,0,0,0,0,0,0,0,0,0,0,0},
  {0,0,0,0,0,0,0,0,0,0,0,0,0,0,0,0,0,0,0,0},
  {0,0,0,0,0,0,0,0,0,0,0,0,0,0,0,0,0,0,0,0},
  {0,0,0,0,0,0,0,0,0,0,0,0,0,0,0,0,0,0,0,0},
  {0,0,0,0,0,0,0,0,0,0,0,0,0,0,0,0,0,0,0,0},
  {0,0,0,0,0,0,0,0,0,0,0,0,0,0,0,0,0,0,0,0},
  {0,0,0,0,0,0,0,0,0,0,0,0,0,0,0,0,0,0,0,0},
  {0,0,0,0,0,0,0,0,0,0,0,0,0,0,0,0,0,0,0,0},
  {0,0,0,0,0,0,0,0,0,0,0,0,0,0,0,0,0,0,0,0},
  {0,0,0,0,0,0,0,0,0,0,0,0,0,0,0,0,0,0,0,0},
  {0,0,0,0,0,0,0,0,0,0,0,0,0,0,0,0,0,0,0,0}
}
loadFG{
  {0,0,0,0,0,0,0,0,0,0,0,0,0,0,0,0,0,0,0,0},
  {0,0,0,0,0,0,0,0,0,0,0,0,0,0,0,0,0,0,0,0},
  {0,0,0,0,0,0,0,0,0,0,0,0,0,0,0,0,0,0,0,0},
  {0,0,0,0,0,0,0,0,0,0,0,0,0,0,0,0,0,0,0,0},
  {0,0,0,0,0,0,0,0,0,0,0,0,0,0,0,0,0,0,0,0},
  {0,0,0,0,0,0,0,0,0,0,0,0,0,0,0,0,0,0,0,0},
  {0,0,0,0,0,0,0,0,0,0,0,0,0,0,0,0,0,0,0,0},
  {0,0,0,0,0,0,0,0,0,0,0,0,0,0,0,0,0,0,0,0},
  {0,0,0,0,0,0,0,0,0,0,0,0,0,0,0,0,0,0,0,0},
  {0,0,0,0,0,0,0,0,0,0,0,0,0,0,0,0,0,0,0,0},
  {0,0,0,0,0,0,0,42,0,0,0,0,0,0,0,0,0,0,0,0},
  {0,0,0,0,0,0,0,42,0,0,0,0,0,0,0,0,0,0,0,0},
  {0,0,0,0,0,0,0,42,0,0,0,0,0,0,0,0,0,0,0,0},
  {0,0,0,0,0,0,0,42,0,0,0,0,0,0,0,0,0,0,0,0},
  {0,0,0,0,0,0,0,42,0,0,0,0,0,0,0,0,0,0,0,0},
  {0,0,0,0,0,0,0,42,0,0,0,0,0,0,0,0,0,0,0,0},
  {0,0,0,0,0,0,0,42,0,0,0,0,0,0,0,0,0,0,0,0},
  {0,0,0,0,0,0,0,42,0,0,0,0,0,0,0,0,0,0,0,0},
  {0,0,0,0,0,0,0,42,0,0,0,0,0,0,0,0,0,0,0,0},
  {0,0,0,0,0,49,49,0,0,0,0,0,0,0,0,0,0,0,0,0},
  {0,0,0,0,0,0,0,0,0,0,0,0,0,0,0,0,0,0,0,0},
  {0,0,0,0,0,0,0,0,0,0,0,0,0,0,0,0,0,0,0,0},
  {0,0,0,0,0,0,0,0,0,0,0,0,0,0,0,0,0,0,0,0},
  {0,0,0,0,0,0,0,0,0,0,0,0,0,0,0,0,0,0,0,0},
  {0,0,0,0,0,0,0,0,0,0,0,0,0,0,0,0,0,0,0,0},
  {0,0,0,0,0,0,0,0,0,0,0,0,0,0,0,0,0,0,0,0},
  {0,0,0,0,0,0,0,0,0,0,0,0,0,0,0,0,0,0,0,0},
  {0,0,0,0,0,0,0,0,0,0,0,0,0,0,0,0,0,0,0,0},
  {0,0,0,0,0,0,0,0,0,0,0,0,0,0,0,0,0,0,0,0},
  {0,0,0,0,0,0,0,0,0,0,0,0,0,0,0,0,0,0,0,0},
  {0,0,0,0,0,0,0,0,0,0,0,0,0,0,0,0,0,0,0,0},
  {0,0,0,0,0,0,0,0,0,0,0,0,0,0,0,0,0,0,0,0}
}
loadOBJ{
  {0,0,0,0,0,0,0,0,0,0,0,0,0,0,0,0,0,0,0,0},
  {0,0,0,0,0,0,0,0,0,0,0,0,0,0,0,0,0,0,0,0},
  {0,0,0,0,0,0,0,0,0,0,0,0,0,0,0,0,0,0,0,0},
  {0,0,0,0,0,0,0,0,0,0,0,0,0,0,0,0,0,0,0,0},
  {0,0,0,0,0,0,0,0,0,0,0,0,0,0,0,2,0,0,0,0},
  {0,0,0,0,0,0,0,0,0,0,0,0,0,0,0,0,0,0,0,0},
  {0,0,0,0,0,0,0,0,0,0,0,0,0,0,0,0,0,0,0,0},
  {0,0,0,0,4,0,0,0,0,0,0,0,0,0,0,0,0,0,0,0},
  {0,0,0,0,0,0,0,0,0,0,0,0,0,0,0,0,0,0,0,0},
  {0,0,0,0,0,0,0,0,0,0,0,0,0,0,0,0,0,0,0,0},
  {0,0,0,0,0,0,0,33,0,0,0,0,0,0,0,0,0,0,0,0},
  {0,0,0,0,0,0,0,33,0,0,0,0,0,0,0,0,0,0,0,0},
  {0,0,0,0,0,0,0,33,0,0,0,0,0,0,0,0,0,0,0,0},
  {0,0,0,0,0,0,0,33,0,0,0,0,0,0,0,0,0,0,0,0},
  {0,0,0,0,0,0,0,33,0,0,0,0,0,0,0,0,0,0,0,0},
  {0,0,0,0,0,0,0,33,0,0,0,0,0,0,0,0,0,0,0,0},
  {0,0,0,0,0,0,0,33,0,0,0,0,0,0,0,0,0,0,0,0},
  {0,0,0,0,0,0,0,33,0,0,0,0,0,0,0,0,0,0,0,0},
  {0,0,0,0,0,0,0,33,0,0,0,0,0,0,0,0,0,0,0,0},
  {0,0,0,0,0,33,33,0,0,0,0,0,0,0,0,0,0,0,0,0},
  {0,0,0,0,0,0,0,0,0,0,0,0,0,0,0,0,0,0,0,0},
  {0,0,0,0,0,0,0,0,0,0,0,0,0,0,0,0,0,0,0,0},
  {0,0,0,0,0,0,0,0,0,0,0,0,0,0,0,0,0,0,0,0},
  {0,0,0,0,0,0,0,0,0,0,0,0,0,0,0,0,0,0,0,0},
  {0,0,0,0,0,0,0,0,0,0,0,0,0,0,0,0,0,0,0,0},
  {0,0,0,0,0,0,0,0,0,0,0,0,0,0,0,0,0,0,0,0},
  {0,0,0,0,0,0,3,0,0,0,0,0,0,0,0,0,0,0,0,0},
  {0,0,0,0,0,0,0,0,0,0,0,0,0,0,0,0,0,0,0,0},
  {0,0,0,0,0,0,0,0,0,0,0,0,0,0,0,0,0,0,0,0},
  {0,0,0,0,0,0,0,0,0,0,0,0,0,0,0,0,0,0,0,0},
  {0,0,0,0,0,0,0,0,0,0,0,0,0,0,0,0,0,0,0,0},
  {0,0,0,0,0,0,0,0,0,0,0,0,0,0,0,0,0,0,0,0}
}
loadWall{
  {18,18,18,18,18,18,18,18,18,18,18,18,18,18,18,18,18,18,18,18},
  {18,18,19,19,19,18,18,18,18,18,18,18,19,19,19,19,18,18,18,18},
  {18,26,0,0,0,10,18,18,18,18,18,26,0,0,0,0,10,18,18,18},
  {18,26,0,0,0,10,18,18,18,18,18,26,0,0,0,0,10,18,18,18},
  {18,26,0,0,0,10,18,18,18,18,18,26,0,0,0,0,10,18,18,18},
  {18,26,0,0,0,10,18,18,18,18,18,26,0,0,0,0,10,18,18,18},
  {18,18,17,25,0,10,18,18,18,18,18,26,0,0,0,0,10,18,18,18},
  {18,18,18,26,0,10,18,18,18,18,18,18,25,0,0,0,10,18,18,19},
  {18,18,19,27,0,10,18,18,18,18,18,18,26,0,0,0,10,18,27,0},
  {18,26,0,0,0,11,19,18,18,18,18,18,26,0,0,0,10,26,0,0},
  {18,26,0,0,0,0,0,0,18,18,18,18,26,0,0,0,11,27,0,0},
  {18,26,0,0,0,0,0,0,18,18,18,18,26,0,0,0,0,0,0,0},
  {18,26,0,0,0,0,0,0,18,18,18,18,18,25,0,0,0,0,0,0},
  {18,26,0,0,0,0,0,0,18,18,18,18,18,27,0,0,0,0,0,0},
  {18,26,0,0,0,0,0,0,18,18,18,18,26,0,0,0,0,0,0,0},
  {18,26,0,0,0,0,0,0,18,18,18,18,26,0,0,0,0,0,0,0},
  {18,26,0,0,0,0,0,0,18,18,18,18,26,0,0,0,0,0,0,0},
  {18,26,0,0,0,0,0,0,18,18,18,18,27,0,0,0,0,0,0,0},
  {18,26,0,0,0,0,0,0,18,18,18,26,0,0,0,0,0,0,0,0},
  {18,18,25,0,9,0,0,18,18,18,18,26,0,0,0,0,0,0,0,0},
  {18,18,26,0,11,19,19,18,18,18,18,26,0,0,0,0,0,0,0,0},
  {18,18,26,0,0,0,0,10,18,18,18,26,0,0,0,0,0,0,0,0},
  {18,18,18,20,20,28,0,10,18,18,18,26,0,0,0,0,0,0,0,0},
  {18,18,26,0,0,0,0,10,18,18,18,26,0,0,0,0,0,0,0,0},
  {18,18,26,0,0,0,0,10,18,18,18,27,0,0,0,0,0,0,0,0},
  {18,18,26,0,0,0,0,10,18,18,26,0,0,0,0,0,0,0,0,0},
  {18,18,26,0,0,0,0,10,18,18,26,0,0,0,0,0,0,0,0,0},
  {18,18,26,0,0,0,0,11,19,19,27,0,0,0,0,0,0,0,0,0},
  {18,18,26,0,0,0,0,0,0,0,0,0,0,0,0,0,0,0,0,0},
  {18,18,26,0,0,0,0,0,0,0,0,0,0,0,0,0,0,0,0,0},
  {18,18,18,17,17,17,17,17,17,17,17,17,17,17,17,17,17,17,17,17},
  {18,18,18,18,18,18,18,18,18,18,18,18,18,18,18,18,18,18,18,18}
}
loadCollision{
  {1,1,1,1,1,1,1,1,1,1,1,1,1,1,1,1,1,1,1,1},
  {1,1,1,1,1,1,1,1,1,1,1,1,1,1,1,1,1,1,1,1},
  {1,1,0,0,0,1,1,1,1,1,1,1,0,0,0,0,1,1,1,1},
  {1,1,0,0,0,1,1,1,1,1,1,1,0,0,0,0,1,1,1,1},
  {1,1,0,0,0,1,1,1,1,1,1,1,0,0,0,0,1,1,1,1},
  {1,1,0,0,0,1,1,1,1,1,1,1,0,0,0,0,1,1,1,1},
  {1,1,1,1,0,1,1,1,1,1,1,1,0,0,0,0,1,1,1,1},
  {1,1,1,1,0,1,1,1,1,1,1,1,1,0,0,0,1,1,1,1},
  {1,1,1,1,0,1,1,1,1,1,1,1,1,0,0,0,1,1,1,0},
  {1,1,0,0,0,1,1,1,1,1,1,1,1,0,0,0,1,1,0,0},
  {1,1,0,0,0,0,0,3,1,1,1,1,1,0,0,0,1,1,0,0},
  {1,1,0,0,0,0,0,3,1,1,1,1,1,0,0,0,0,0,0,0},
  {1,1,0,0,0,0,0,3,1,1,1,1,1,1,0,0,0,0,0,0},
  {1,1,0,0,0,0,0,3,1,1,1,1,1,1,0,0,0,0,0,0},
  {1,1,0,0,0,0,0,3,1,1,1,1,1,0,0,0,0,0,0,0},
  {1,1,0,0,0,0,0,3,1,1,1,1,1,0,0,0,0,0,0,0},
  {1,1,0,0,0,0,0,3,1,1,1,1,1,0,0,0,0,0,0,0},
  {1,1,0,0,0,0,0,3,1,1,1,1,1,0,0,0,0,0,0,0},
  {1,1,0,0,0,0,0,3,1,1,1,1,0,0,0,0,0,0,0,0},
  {1,1,1,0,1,3,3,1,1,1,1,1,0,0,0,0,0,0,0,0},
  {1,1,1,0,1,1,1,1,1,1,1,1,0,0,0,0,0,0,0,0},
  {1,1,1,0,0,0,0,1,1,1,1,1,0,0,0,0,0,0,0,0},
  {1,1,1,1,1,1,0,1,1,1,1,1,0,0,0,0,0,0,0,0},
  {1,1,1,0,0,0,0,1,1,1,1,1,0,0,0,0,0,0,0,0},
  {1,1,1,0,0,0,0,1,1,1,1,1,0,0,0,0,0,0,0,0},
  {1,1,1,0,0,0,0,1,1,1,1,0,0,0,0,0,0,0,0,0},
  {1,1,1,0,0,0,0,1,1,1,1,0,0,0,0,0,0,0,0,0},
  {1,1,1,0,0,0,0,1,1,1,1,0,0,0,0,0,0,0,0,0},
  {1,1,1,0,0,0,0,0,0,0,0,0,0,0,0,0,0,0,0,0},
  {1,1,1,0,0,0,0,0,0,0,0,0,0,0,0,0,0,0,0,0},
  {1,1,1,1,1,1,1,1,1,1,1,1,1,1,1,1,1,1,1,1},
  {1,1,1,1,1,1,1,1,1,1,1,1,1,1,1,1,1,1,1,1}
}
