mapSize(72, 20)
start{x=5,y=17}
loadBG{
  {18,18,18,18,18,18,18,18,18,18,18,18,18,18,18,18,18,18,18,18},
  {18,18,18,18,18,18,18,18,18,18,18,19,19,19,19,19,19,18,18,18},
  {18,18,18,18,18,18,18,18,18,18,26,0,0,0,0,0,0,10,18,18},
  {18,18,18,18,18,18,18,18,18,18,26,0,0,0,0,0,0,10,18,18},
  {18,18,18,18,18,18,18,18,18,18,26,0,0,0,0,0,0,10,18,18},
  {18,18,18,18,18,18,18,18,18,18,26,0,0,0,0,0,0,10,18,18},
  {18,18,18,18,18,18,18,18,18,18,26,0,0,0,0,0,0,10,18,18},
  {18,18,18,18,18,18,18,18,18,18,26,0,0,0,0,0,0,10,18,18},
  {18,18,18,18,18,18,18,18,18,18,18,17,25,0,0,0,0,10,18,18},
  {18,18,19,19,19,19,19,19,19,19,19,19,27,0,0,0,0,10,18,18},
  {18,26,0,0,0,0,0,0,0,0,0,0,0,0,0,0,0,10,18,18},
  {18,26,0,0,0,0,0,0,0,0,0,0,0,0,0,0,0,10,18,18},
  {18,26,0,0,0,0,0,0,0,0,0,0,0,0,0,0,0,10,18,18},
  {18,26,0,0,0,0,0,0,0,0,0,0,0,0,0,0,0,10,18,18},
  {18,26,0,0,0,0,0,0,0,0,0,0,0,0,0,0,0,10,18,18},
  {18,26,0,0,0,0,0,0,0,0,0,0,0,0,0,0,0,10,18,18},
  {18,26,0,0,0,0,0,0,0,0,0,0,0,0,0,0,0,10,18,18},
  {18,26,0,0,0,0,0,0,0,0,0,0,0,0,0,0,0,10,18,18},
  {18,26,0,0,0,0,0,0,0,0,0,0,0,0,0,0,0,10,18,18},
  {18,26,0,0,0,0,0,0,0,0,0,0,0,0,0,0,0,10,18,18},
  {18,26,0,0,0,0,0,0,0,0,0,0,0,0,0,0,0,10,18,18},
  {18,26,0,0,0,0,0,0,0,0,0,0,0,0,0,0,0,10,18,18},
  {18,26,0,0,0,0,0,0,0,0,0,0,0,0,0,0,0,10,18,18},
  {18,26,0,0,0,0,0,0,0,0,0,0,0,0,0,0,0,10,18,18},
  {18,26,0,0,0,0,0,0,0,0,0,0,0,0,0,0,0,10,18,18},
  {18,26,0,0,0,0,0,0,0,0,0,0,0,0,0,0,0,10,18,18},
  {18,26,0,0,0,0,0,0,0,0,0,0,0,0,0,12,20,18,18,18},
  {18,26,0,0,0,0,0,0,0,0,0,0,0,0,0,0,0,10,18,18},
  {18,26,0,0,0,0,0,0,0,0,0,0,0,0,0,0,0,10,18,18},
  {18,26,0,0,0,0,0,0,0,0,0,0,0,0,0,0,0,10,18,18},
  {18,18,17,17,17,17,17,17,17,17,17,17,25,0,0,0,0,10,18,18},
  {18,18,19,19,19,19,19,19,19,19,19,19,27,0,0,0,0,10,18,18},
  {18,26,0,0,0,0,0,0,0,0,0,0,0,0,0,0,0,10,18,18},
  {18,26,0,0,0,0,0,0,0,0,0,0,0,0,0,0,0,10,18,18},
  {18,26,0,0,0,0,0,0,0,0,0,0,0,0,0,0,0,10,18,18},
  {18,26,0,0,0,0,0,0,0,0,0,0,0,0,0,0,0,10,18,18},
  {18,26,0,0,0,0,0,0,0,0,0,0,0,0,0,0,0,10,18,18},
  {18,26,0,0,0,0,0,0,0,0,0,0,0,0,0,0,0,10,18,18},
  {18,26,0,0,0,0,0,0,0,0,0,0,0,0,0,0,0,10,18,18},
  {18,26,0,0,0,0,0,0,0,0,0,0,0,0,0,0,0,10,18,18},
  {18,26,0,0,0,0,0,0,0,0,0,0,0,0,0,0,0,10,18,18},
  {18,26,0,0,0,0,0,0,0,0,0,0,0,0,0,0,0,10,18,18},
  {18,26,0,0,0,0,0,0,0,0,0,0,0,0,0,0,0,10,18,18},
  {18,26,0,0,0,0,0,0,0,0,0,0,0,0,0,0,0,10,18,18},
  {18,26,0,0,0,0,0,0,0,0,0,0,0,0,4,0,0,10,18,18},
  {18,26,0,0,0,0,0,0,0,0,0,0,0,0,0,0,0,10,18,18},
  {18,26,0,0,0,0,0,0,0,0,0,0,0,0,0,0,0,10,18,18},
  {18,26,0,0,0,0,0,0,0,0,0,0,0,0,0,0,0,10,18,18},
  {18,26,0,0,0,0,0,0,0,0,0,0,0,0,0,0,0,18,18,18},
  {18,26,0,0,0,0,0,0,0,0,0,0,0,0,0,0,0,10,18,18},
  {18,26,0,0,0,0,0,0,0,0,0,0,0,0,0,0,0,10,18,18},
  {18,26,0,0,0,0,0,0,0,0,0,0,0,0,0,0,0,10,18,18},
  {18,18,17,17,17,17,17,17,17,17,17,17,25,0,0,0,0,10,18,18},
  {18,18,19,19,19,19,19,19,19,19,19,19,27,0,0,0,0,10,18,18},
  {18,26,0,0,0,0,0,0,0,0,0,0,0,0,0,0,0,10,18,18},
  {18,26,0,0,0,0,0,0,0,0,0,0,0,0,0,0,0,10,18,18},
  {18,26,0,0,0,0,0,0,0,0,0,0,0,0,0,0,0,10,18,18},
  {18,26,0,0,0,0,0,0,0,0,0,12,20,28,0,0,0,10,18,18},
  {18,26,0,0,0,0,0,0,0,0,0,0,0,0,0,0,0,10,18,18},
  {18,26,0,0,0,0,0,0,0,0,0,0,0,0,0,0,0,10,18,18},
  {18,26,0,0,0,0,0,0,0,0,0,0,0,0,0,0,0,10,18,18},
  {18,26,0,0,0,0,0,0,0,0,0,0,9,17,17,17,17,18,18,18},
  {18,26,0,0,0,0,0,0,0,0,0,0,10,18,18,18,18,18,18,18},
  {18,26,0,0,0,0,0,0,0,0,0,0,10,18,18,18,18,18,18,18},
  {18,26,0,0,0,0,0,0,0,0,0,0,10,18,18,18,18,18,18,18},
  {18,26,0,0,0,0,0,9,17,17,17,17,18,18,18,18,18,18,18,18},
  {18,26,0,0,0,0,0,10,18,18,18,18,18,18,18,18,18,18,18,18},
  {18,26,0,0,0,0,0,10,18,18,18,18,18,18,18,18,18,18,18,18},
  {18,26,0,0,0,0,0,10,18,18,18,18,18,18,18,18,18,18,18,18},
  {18,26,0,0,0,0,0,10,18,18,18,18,18,18,18,18,18,18,18,18},
  {18,18,17,17,17,17,17,18,18,18,18,18,18,18,18,18,18,18,18,18},
  {18,18,18,18,18,18,18,18,18,18,18,18,18,18,18,18,18,18,18,18}
}
loadFG{
  {0,0,0,0,0,0,0,0,0,0,0,0,0,0,0,0,0,0,0,0},
  {0,0,0,0,0,0,0,0,0,0,0,0,0,0,0,0,0,0,0,0},
  {0,0,0,0,0,0,0,0,0,0,0,0,0,0,0,0,0,0,0,0},
  {0,0,0,0,0,0,0,0,0,0,0,0,0,0,0,0,0,0,0,0},
  {0,0,0,0,0,0,0,0,0,0,0,0,0,0,0,0,0,0,0,0},
  {0,0,0,0,0,0,0,0,0,0,0,0,0,0,0,0,0,0,0,0},
  {0,0,0,0,0,0,0,0,0,0,0,0,0,0,0,0,0,0,0,0},
  {0,0,0,0,0,0,0,0,0,0,0,0,0,0,0,0,0,0,0,0},
  {0,0,0,0,0,0,0,0,0,0,0,0,0,0,0,0,0,0,0,0},
  {0,0,0,0,0,0,0,0,0,0,0,0,0,0,0,0,0,0,0,0},
  {0,0,0,0,0,0,0,0,0,0,0,0,0,0,0,0,0,0,0,0},
  {0,0,0,0,0,0,0,0,0,0,0,0,0,0,0,0,0,0,0,0},
  {0,0,0,0,0,0,0,0,0,0,0,0,0,0,0,0,0,0,0,0},
  {0,0,0,0,0,0,0,0,0,0,0,0,0,0,0,0,0,0,0,0},
  {0,0,0,0,0,0,0,0,0,0,0,0,0,0,0,0,0,0,0,0},
  {0,0,0,0,0,0,0,0,0,0,0,0,0,0,0,0,0,0,0,0},
  {0,0,0,0,0,0,0,0,0,0,0,0,0,0,0,0,0,0,0,0},
  {0,0,0,0,0,0,0,0,0,0,0,0,0,0,0,0,0,0,0,0},
  {0,0,0,0,0,0,0,0,0,0,0,0,0,0,0,0,0,0,0,0},
  {0,0,0,0,0,0,0,0,0,0,0,0,0,0,0,0,0,0,0,0},
  {0,0,0,0,0,0,0,0,0,0,0,0,0,0,0,0,0,0,0,0},
  {0,0,0,0,0,0,0,0,0,0,0,0,0,0,0,0,0,0,0,0},
  {0,0,0,0,0,0,0,0,0,0,0,0,0,0,0,0,0,0,0,0},
  {0,0,0,0,0,0,0,0,0,0,0,0,0,0,0,0,0,0,0,0},
  {0,0,0,0,0,0,0,0,0,0,0,0,0,0,0,0,0,0,0,0},
  {0,0,0,0,0,0,0,0,0,0,0,0,0,0,0,0,0,0,0,0},
  {0,0,0,0,0,0,0,0,0,0,0,0,0,0,0,0,0,0,0,0},
  {0,0,0,0,0,0,0,0,0,0,0,0,0,0,0,0,0,0,0,0},
  {0,0,0,0,0,0,0,0,0,0,0,0,0,0,0,0,0,0,0,0},
  {0,0,0,0,0,0,0,0,0,0,0,0,0,0,0,0,0,0,0,0},
  {0,0,0,0,0,0,0,0,0,0,0,0,0,0,0,0,0,0,0,0},
  {0,0,0,0,0,0,0,0,0,0,0,0,0,0,0,0,0,0,0,0},
  {0,0,0,0,0,0,0,0,0,0,0,0,0,0,0,0,0,0,0,0},
  {0,0,0,0,0,0,0,0,0,0,0,0,0,0,0,0,0,0,0,0},
  {0,0,0,0,0,0,0,0,0,0,0,0,0,0,0,0,0,0,0,0},
  {0,0,0,0,0,0,0,0,0,0,0,0,0,0,0,0,0,0,0,0},
  {0,0,0,0,0,0,0,0,0,0,0,0,0,0,0,0,0,0,0,0},
  {0,0,0,0,0,0,0,0,0,0,0,0,0,0,0,0,0,0,0,0},
  {0,0,0,0,0,0,0,0,0,0,0,0,0,0,0,0,0,0,0,0},
  {0,0,0,0,0,0,0,0,0,0,0,0,0,0,0,0,0,0,0,0},
  {0,0,0,0,0,0,0,0,0,0,0,0,0,0,0,0,0,0,0,0},
  {0,0,0,0,0,0,0,0,0,0,0,0,0,0,0,0,0,0,0,0},
  {0,0,0,0,0,0,0,0,0,0,0,0,0,0,0,0,0,0,0,0},
  {0,0,0,0,0,0,0,0,0,0,0,0,0,0,0,0,0,0,0,0},
  {0,0,0,0,0,0,0,0,0,0,0,0,0,0,0,0,0,0,0,0},
  {0,0,0,0,0,0,0,0,0,0,0,0,0,0,0,0,0,0,0,0},
  {0,0,0,0,0,0,0,0,0,0,0,0,0,0,0,0,0,0,0,0},
  {0,0,0,0,0,0,0,0,0,0,0,0,0,0,0,0,0,0,0,0},
  {0,0,0,0,0,0,0,0,0,0,0,0,0,0,0,0,0,0,0,0},
  {0,0,0,0,0,0,0,0,0,0,0,0,0,0,0,0,0,0,0,0},
  {0,0,0,0,0,0,0,0,0,0,0,0,0,0,0,0,0,0,0,0},
  {0,0,0,0,0,0,0,0,0,0,0,0,0,0,0,0,0,0,0,0},
  {0,0,0,0,0,0,0,0,0,0,0,0,0,0,0,0,0,0,0,0},
  {0,0,0,0,0,0,0,0,0,0,0,0,0,0,0,0,0,0,0,0},
  {0,0,0,0,0,0,0,0,0,0,0,0,0,0,0,0,0,0,0,0},
  {0,0,0,0,0,0,0,0,0,0,0,0,0,0,0,0,0,0,0,0},
  {0,0,0,0,0,0,0,0,0,0,0,0,0,0,0,0,0,0,0,0},
  {0,0,0,0,0,0,0,0,0,0,0,0,0,0,0,0,0,0,0,0},
  {0,0,0,0,0,0,0,0,0,0,0,0,0,0,0,0,0,0,0,0},
  {0,0,0,0,0,0,0,0,0,0,0,0,0,0,0,0,0,0,0,0},
  {0,0,0,0,0,0,0,0,0,0,0,0,0,0,0,0,0,0,0,0},
  {0,0,0,0,0,0,0,0,0,0,0,0,0,0,0,0,0,0,0,0},
  {0,0,0,0,0,0,0,0,0,0,0,0,0,0,0,0,0,0,0,0},
  {0,0,0,0,0,0,0,0,0,0,0,0,0,0,0,0,0,0,0,0},
  {0,0,0,0,0,0,0,0,0,0,0,0,0,0,0,0,0,0,0,0},
  {0,0,0,0,0,0,0,0,0,0,0,0,0,0,0,0,0,0,0,0},
  {0,0,0,0,0,0,0,0,0,0,0,0,0,0,0,0,0,0,0,0},
  {0,0,0,0,0,0,0,0,0,0,0,0,0,0,0,0,0,0,0,0},
  {0,0,0,0,0,0,0,0,0,0,0,0,0,0,0,0,0,0,0,0},
  {0,0,0,0,0,0,0,0,0,0,0,0,0,0,0,0,0,0,0,0},
  {0,0,0,0,0,0,0,0,0,0,0,0,0,0,0,0,0,0,0,0},
  {0,0,0,0,0,0,0,0,0,0,0,0,0,0,0,0,0,0,0,0}
}
loadOBJ{
  {0,0,0,0,0,0,0,0,0,0,0,0,0,0,0,0,0,0,0,0},
  {0,0,0,0,0,0,0,0,0,0,0,0,0,0,0,0,0,0,0,0},
  {0,0,0,0,0,0,0,0,0,0,0,0,0,0,0,0,0,0,0,0},
  {0,0,0,0,0,0,0,0,0,0,0,0,0,0,0,0,0,0,0,0},
  {0,0,0,0,0,0,0,0,0,0,0,0,0,0,0,0,0,0,0,0},
  {0,0,0,0,0,0,0,0,0,0,0,0,0,0,0,0,0,0,0,0},
  {0,0,0,0,0,0,0,0,0,0,0,0,0,0,0,0,0,0,0,0},
  {0,0,0,0,0,0,0,0,0,0,0,0,0,0,0,0,0,0,0,0},
  {0,0,0,0,0,0,0,0,0,0,0,0,0,0,0,0,0,0,0,0},
  {0,0,0,0,0,0,0,0,0,0,0,0,0,0,0,0,0,0,0,0},
  {0,0,0,0,0,0,0,0,0,0,0,0,0,0,0,0,0,0,0,0},
  {0,0,0,0,0,0,0,0,0,0,0,0,0,0,0,0,0,0,0,0},
  {0,0,0,0,0,0,0,0,0,0,0,0,0,0,0,0,0,0,0,0},
  {0,0,0,0,0,0,0,0,0,0,0,0,0,0,0,0,0,0,0,0},
  {0,0,0,0,0,0,0,0,0,0,0,0,0,0,0,0,0,0,0,0},
  {0,0,0,0,0,0,0,0,0,0,0,0,0,0,0,0,0,0,0,0},
  {0,0,0,0,0,0,0,0,0,0,0,0,0,0,0,0,0,0,0,0},
  {0,0,0,0,0,0,0,0,0,0,0,0,0,0,0,0,0,0,0,0},
  {0,0,0,0,0,0,0,0,0,0,0,0,0,0,0,0,0,0,0,0},
  {0,0,0,0,0,0,13,0,0,0,0,0,0,0,0,0,0,0,0,0},
  {0,0,0,0,0,0,0,0,0,0,0,0,0,0,0,0,0,0,0,0},
  {0,0,0,0,0,0,0,0,0,0,0,0,0,0,0,0,0,0,0,0},
  {0,0,0,0,0,0,0,0,0,0,0,0,0,0,0,0,0,0,0,0},
  {0,0,0,0,0,0,0,0,0,0,0,0,0,0,0,0,0,0,0,0},
  {0,0,0,0,0,0,0,0,0,0,0,0,0,0,0,0,0,0,0,0},
  {0,0,0,0,0,0,0,0,0,0,0,0,0,0,0,0,0,0,0,0},
  {0,0,0,0,0,0,0,0,0,0,0,0,0,0,0,0,0,0,0,0},
  {0,0,0,0,0,0,0,0,0,0,0,0,0,0,0,0,0,0,0,0},
  {0,0,0,0,0,0,0,0,0,0,0,0,0,0,0,0,0,0,0,0},
  {0,0,0,0,0,0,0,0,0,0,0,0,0,0,0,0,0,0,0,0},
  {0,0,0,0,0,0,0,0,0,0,0,0,0,0,0,0,0,0,0,0},
  {0,0,0,0,0,0,0,0,0,0,0,0,0,0,0,0,0,0,0,0},
  {0,0,0,0,0,0,0,0,0,0,0,0,0,0,0,0,0,0,0,0},
  {0,0,0,0,0,0,0,0,0,0,0,0,0,0,0,0,0,0,0,0},
  {0,0,0,0,0,0,0,0,0,0,0,0,0,0,0,0,0,0,0,0},
  {0,0,0,0,0,0,0,0,0,0,0,0,0,0,0,0,0,0,0,0},
  {0,0,0,0,0,0,0,0,0,0,0,0,0,0,0,0,0,0,0,0},
  {0,0,0,0,0,0,0,0,0,0,0,0,0,0,0,0,0,0,0,0},
  {0,0,0,0,0,0,0,0,0,0,0,0,0,0,0,0,0,0,0,0},
  {0,0,0,0,0,0,0,0,0,0,0,0,0,0,0,0,0,0,0,0},
  {0,0,0,0,0,0,0,0,0,0,0,0,0,0,0,0,0,0,0,0},
  {0,0,0,0,0,0,13,0,0,0,0,0,0,0,0,0,0,0,0,0},
  {0,0,0,0,0,0,0,0,0,0,0,0,0,0,0,0,0,0,0,0},
  {0,0,0,0,0,0,0,0,0,0,0,0,0,0,0,0,0,0,0,0},
  {0,0,0,0,0,0,0,0,0,0,0,0,0,0,0,0,0,0,0,0},
  {0,0,0,0,0,0,0,0,0,0,0,0,0,0,0,0,0,0,0,0},
  {0,0,0,0,0,0,0,0,0,0,0,0,0,0,0,0,0,0,0,0},
  {0,0,0,0,0,0,0,0,0,0,0,0,0,0,0,0,0,0,0,0},
  {0,0,0,0,0,0,0,0,0,0,0,44,52,52,52,52,52,0,0,0},
  {0,0,0,0,0,0,0,0,0,0,0,0,0,0,0,0,0,0,0,0},
  {0,0,0,0,0,0,0,0,0,0,0,0,0,0,0,0,0,0,0,0},
  {0,0,0,0,0,0,0,0,0,0,0,0,0,0,0,0,0,0,0,0},
  {0,0,0,0,0,0,0,0,0,0,0,0,0,0,0,0,0,0,0,0},
  {0,0,0,0,0,0,0,0,0,0,0,0,0,0,0,0,0,0,0,0},
  {0,0,0,0,0,0,0,0,0,0,0,0,0,0,0,0,0,0,0,0},
  {0,0,0,0,0,0,0,0,0,0,0,0,0,0,0,0,0,0,0,0},
  {0,0,0,0,0,0,0,0,0,0,0,0,0,0,0,0,0,0,0,0},
  {0,0,0,0,13,0,0,0,0,0,0,0,0,0,0,0,0,0,0,0},
  {0,0,0,0,0,0,0,0,0,0,0,0,0,0,0,0,0,0,0,0},
  {0,0,0,0,0,0,0,0,0,0,0,0,0,0,0,0,0,0,0,0},
  {0,0,0,0,0,0,0,0,0,0,0,0,0,0,0,0,0,0,0,0},
  {0,0,0,0,0,0,0,0,0,0,0,0,0,0,0,0,0,0,0,0},
  {0,0,0,0,0,0,0,0,0,0,0,0,0,0,0,0,0,0,0,0},
  {0,0,0,0,0,0,0,0,0,0,0,0,0,0,0,0,0,0,0,0},
  {0,0,0,0,0,0,0,0,0,0,0,0,0,0,0,0,0,0,0,0},
  {0,0,0,0,0,0,0,0,0,0,0,0,0,0,0,0,0,0,0,0},
  {0,0,0,0,0,0,0,0,0,0,0,0,0,0,0,0,0,0,0,0},
  {0,0,0,0,0,0,0,0,0,0,0,0,0,0,0,0,0,0,0,0},
  {0,0,0,0,0,0,2,0,0,0,0,0,0,0,0,0,0,0,0,0},
  {0,0,0,0,0,0,0,0,0,0,0,0,0,0,0,0,0,0,0,0},
  {0,0,0,0,0,0,0,0,0,0,0,0,0,0,0,0,0,0,0,0},
  {0,0,0,0,0,0,0,0,0,0,0,0,0,0,0,0,0,0,0,0}
}
loadCollision{
  {1,1,1,1,1,1,1,1,1,1,1,1,1,1,1,1,1,1,1,1},
  {1,1,1,1,1,1,1,1,1,1,1,1,1,1,1,1,1,1,1,1},
  {1,1,1,1,1,1,1,1,1,1,1,0,0,0,0,0,0,1,1,1},
  {1,1,1,1,1,1,1,1,1,1,1,0,0,0,0,0,0,1,1,1},
  {1,1,1,1,1,1,1,1,1,1,1,0,0,0,0,0,0,1,1,1},
  {1,1,1,1,1,1,1,1,1,1,1,0,0,0,0,0,0,1,1,1},
  {1,1,1,1,1,1,1,1,1,1,1,0,0,0,0,0,0,1,1,1},
  {1,1,1,1,1,1,1,1,1,1,1,0,0,0,0,0,0,1,1,1},
  {1,1,1,1,1,1,1,1,1,1,1,1,1,0,0,0,0,1,1,1},
  {1,1,1,1,1,1,1,1,1,1,1,1,1,0,0,0,0,1,1,1},
  {1,1,0,0,0,0,0,0,0,0,0,0,0,0,0,0,0,1,1,1},
  {1,1,0,0,0,0,0,0,0,0,0,0,0,0,0,0,0,1,1,1},
  {1,1,0,0,0,0,0,0,0,0,0,0,0,0,0,0,0,1,1,1},
  {1,1,0,0,0,0,0,0,0,0,0,0,0,0,0,0,0,1,1,1},
  {1,1,0,0,0,0,0,0,0,0,0,0,0,0,0,0,0,1,1,1},
  {1,1,0,0,0,0,0,0,0,0,0,0,0,0,0,0,0,1,1,1},
  {1,1,0,0,0,0,0,0,0,0,0,0,0,0,0,0,0,1,1,1},
  {1,1,0,0,0,0,0,0,0,0,0,0,0,0,0,0,0,1,1,1},
  {1,1,0,0,0,0,0,0,0,0,0,0,0,0,0,0,0,1,1,1},
  {1,1,0,0,0,0,0,0,0,0,0,0,0,0,0,0,0,1,1,1},
  {1,1,0,0,0,0,0,0,0,0,0,0,0,0,0,0,0,1,1,1},
  {1,1,0,0,0,0,0,0,0,0,0,0,0,0,0,0,0,1,1,1},
  {1,1,0,0,0,0,0,0,0,0,0,0,0,0,0,0,0,1,1,1},
  {1,1,0,0,0,0,0,0,0,0,0,0,0,0,0,0,0,1,1,1},
  {1,1,0,0,0,0,0,0,0,0,0,0,0,0,0,0,0,1,1,1},
  {1,1,0,0,0,0,0,0,0,0,0,0,0,0,0,0,0,1,1,1},
  {1,1,0,0,0,0,0,0,0,0,0,0,0,0,0,1,1,1,1,1},
  {1,1,0,0,0,0,0,0,0,0,0,0,0,0,0,0,0,1,1,1},
  {1,1,0,0,0,0,0,0,0,0,0,0,0,0,0,0,0,1,1,1},
  {1,1,0,0,0,0,0,0,0,0,0,0,0,0,0,0,0,1,1,1},
  {1,1,1,1,1,1,1,1,1,1,1,1,1,0,0,0,0,1,1,1},
  {1,1,1,1,1,1,1,1,1,1,1,1,1,0,0,0,0,1,1,1},
  {1,1,0,0,0,0,0,0,0,0,0,0,0,0,0,0,0,1,1,1},
  {1,1,0,0,0,0,0,0,0,0,0,0,0,0,0,0,0,1,1,1},
  {1,1,0,0,0,0,0,0,0,0,0,0,0,0,0,0,0,1,1,1},
  {1,1,0,0,0,0,0,0,0,0,0,0,0,0,0,0,0,1,1,1},
  {1,1,0,0,0,0,0,0,0,0,0,0,0,0,0,0,0,1,1,1},
  {1,1,0,0,0,0,0,0,0,0,0,0,0,0,0,0,0,1,1,1},
  {1,1,0,0,0,0,0,0,0,0,0,0,0,0,0,0,0,1,1,1},
  {1,1,0,0,0,0,0,0,0,0,0,0,0,0,0,0,0,1,1,1},
  {1,1,0,0,0,0,0,0,0,0,0,0,0,0,0,0,0,1,1,1},
  {1,1,0,0,0,0,0,0,0,0,0,0,0,0,0,0,0,1,1,1},
  {1,1,0,0,0,0,0,0,0,0,0,0,0,0,0,0,0,1,1,1},
  {1,1,0,0,0,0,0,0,0,0,0,0,0,0,0,0,0,1,1,1},
  {1,1,0,0,0,0,0,0,0,0,0,0,0,0,1,0,0,1,1,1},
  {1,1,0,0,0,0,0,0,0,0,0,0,0,0,0,0,0,1,1,1},
  {1,1,0,0,0,0,0,0,0,0,0,0,0,0,0,0,0,1,1,1},
  {1,1,0,0,0,0,0,0,0,0,0,0,0,0,0,0,0,1,1,1},
  {1,1,0,0,0,0,0,0,0,0,0,3,3,3,3,3,3,1,1,1},
  {1,1,0,0,0,0,0,0,0,0,0,0,0,0,0,0,0,1,1,1},
  {1,1,0,0,0,0,0,0,0,0,0,0,0,0,0,0,0,1,1,1},
  {1,1,0,0,0,0,0,0,0,0,0,0,0,0,0,0,0,1,1,1},
  {1,1,1,1,1,1,1,1,1,1,1,1,1,0,0,0,0,1,1,1},
  {1,1,1,1,1,1,1,1,1,1,1,1,1,0,0,0,0,1,1,1},
  {1,1,0,0,0,0,0,0,0,0,0,0,0,0,0,0,0,1,1,1},
  {1,1,0,0,0,0,0,0,0,0,0,0,0,0,0,0,0,1,1,1},
  {1,1,0,0,0,0,0,0,0,0,0,0,0,0,0,0,0,1,1,1},
  {1,1,0,0,0,0,0,0,0,0,0,1,1,1,0,0,0,1,1,1},
  {1,1,0,0,0,0,0,0,0,0,0,0,0,0,0,0,0,1,1,1},
  {1,1,0,0,0,0,0,0,0,0,0,0,0,0,0,0,0,1,1,1},
  {1,1,0,0,0,0,0,0,0,0,0,0,0,0,0,0,0,1,1,1},
  {1,1,0,0,0,0,0,0,0,0,0,0,1,1,1,1,1,1,1,1},
  {1,1,0,0,0,0,0,0,0,0,0,0,1,1,1,1,1,1,1,1},
  {1,1,0,0,0,0,0,0,0,0,0,0,1,1,1,1,1,1,1,1},
  {1,1,0,0,0,0,0,0,0,0,0,0,1,1,1,1,1,1,1,1},
  {1,1,0,0,0,0,0,1,1,1,1,1,1,1,1,1,1,1,1,1},
  {1,1,0,0,0,0,0,1,1,1,1,1,1,1,1,1,1,1,1,1},
  {1,1,0,0,0,0,0,1,1,1,1,1,1,1,1,1,1,1,1,1},
  {1,1,0,0,0,0,0,1,1,1,1,1,1,1,1,1,1,1,1,1},
  {1,1,0,0,0,0,0,1,1,1,1,1,1,1,1,1,1,1,1,1},
  {1,1,1,1,1,1,1,1,1,1,1,1,1,1,1,1,1,1,1,1},
  {1,1,1,1,1,1,1,1,1,1,1,1,1,1,1,1,1,1,1,1}
}
