mapSize(42, 20, 40, 50)
imageFilename("tiles6_gapped.png")
start{x=9,y=18}
loadTiles{
  {0,0,0,0,0,0,0,0,0,0,0,0,0,0,0,0,0,0,0,0},
  {0,0,0,0,0,0,0,0,0,0,0,0,0,0,0,0,0,0,1,0},
  {0,0,0,0,0,0,0,0,0,0,0,0,0,0,0,0,0,0,8,13},
  {0,0,0,0,0,0,0,0,0,0,0,0,0,0,0,0,0,0,8,14},
  {0,0,0,0,0,0,0,0,0,0,0,0,0,0,0,0,0,0,8,14},
  {0,0,0,0,0,0,0,0,0,0,0,0,0,0,0,0,0,0,8,14},
  {0,0,0,0,0,0,0,0,0,0,0,0,0,0,0,0,0,0,8,14},
  {0,0,0,0,0,0,0,0,0,0,0,0,0,0,0,0,0,0,8,14},
  {0,0,0,0,0,0,0,0,0,0,0,0,0,0,0,0,0,0,8,14},
  {0,0,0,0,0,0,0,0,0,0,0,0,0,0,0,0,0,0,8,14},
  {0,0,0,0,0,0,0,0,0,0,0,0,0,0,0,0,0,0,8,14},
  {0,0,0,0,0,0,0,0,0,0,0,0,0,0,0,0,0,0,8,14},
  {0,0,0,0,0,0,0,0,0,0,0,0,0,0,0,0,0,0,8,14},
  {0,0,0,0,0,0,0,0,0,0,0,0,0,0,0,34,40,40,14,14},
  {0,0,0,0,0,0,0,0,0,0,0,0,0,0,0,0,0,0,8,14},
  {0,0,0,0,0,0,0,0,0,0,0,0,0,0,0,0,0,0,8,14},
  {0,0,0,0,0,0,0,0,0,0,0,0,0,0,0,0,0,0,8,14},
  {0,0,0,0,0,0,0,0,0,0,0,0,0,0,0,0,0,0,8,14},
  {0,0,0,0,0,0,0,0,0,0,0,0,0,0,0,0,0,0,8,14},
  {0,0,0,0,0,0,0,0,0,0,0,0,0,0,0,0,0,0,8,14},
  {0,0,0,0,0,0,0,0,0,0,0,0,0,0,0,0,0,0,8,14},
  {0,0,0,0,0,0,0,0,0,0,0,0,0,0,0,0,0,0,8,14},
  {0,0,0,0,0,0,0,0,0,0,0,0,0,0,0,0,0,42,8,14},
  {0,0,0,0,0,0,0,0,0,0,0,0,0,0,0,0,0,0,8,14},
  {0,0,0,0,0,0,0,0,0,0,0,0,0,0,0,0,0,0,8,14},
  {0,0,0,0,0,0,0,0,0,0,0,0,0,0,0,0,0,0,8,14},
  {0,0,0,0,0,0,0,0,0,0,0,0,0,0,0,0,0,0,8,14},
  {0,0,0,0,0,0,0,0,7,13,13,13,13,13,13,13,13,13,14,14},
  {0,0,0,0,0,0,0,0,9,15,15,15,15,15,15,15,15,15,14,14},
  {0,0,0,0,0,0,0,0,0,0,0,0,0,0,0,0,0,0,8,14},
  {0,0,0,0,0,0,0,0,0,0,0,0,0,0,0,0,0,0,8,14},
  {0,0,0,0,0,0,0,0,0,0,0,0,0,0,0,0,0,0,8,14},
  {0,0,0,0,0,0,0,0,0,0,0,0,0,0,0,0,0,0,8,14},
  {0,0,0,0,0,0,0,0,0,0,0,0,0,0,0,0,0,0,8,14},
  {0,0,0,0,0,0,0,0,0,0,0,0,0,0,0,0,0,0,8,14},
  {0,0,0,0,0,0,0,0,0,0,0,0,0,0,0,0,0,48,8,14},
  {0,0,0,0,0,0,0,0,0,0,0,0,0,0,0,0,0,0,8,14},
  {0,0,0,0,0,0,0,0,0,0,0,0,0,0,0,0,0,0,8,14},
  {0,0,0,0,0,0,0,0,0,0,0,0,0,0,0,0,0,0,8,14},
  {0,0,0,0,0,0,0,0,0,0,0,0,0,0,0,0,0,0,8,15},
  {0,0,0,0,0,0,0,0,0,0,0,0,0,0,0,0,0,0,3,0},
  {0,0,0,0,0,0,0,0,0,0,0,0,0,0,0,0,0,0,0,0}
}
loadCollision{
  {0,0,0,0,0,0,0,0,0,0,0,0,0,0,0,0,0,0,0,0},
  {0,0,0,0,0,0,0,0,0,0,0,0,0,0,0,0,0,0,1,0},
  {0,0,0,0,0,0,0,0,0,0,0,0,0,0,0,0,0,0,1,1},
  {0,0,0,0,0,0,0,0,0,0,0,0,0,0,0,0,0,0,1,1},
  {0,0,0,0,0,0,0,0,0,0,0,0,0,0,0,0,0,0,1,1},
  {0,0,0,0,0,0,0,0,0,0,0,0,0,0,0,0,0,0,1,1},
  {0,0,0,0,0,0,0,0,0,0,0,0,0,0,0,0,0,0,1,1},
  {0,0,0,0,0,0,0,0,0,0,0,0,0,0,0,0,0,0,1,1},
  {0,0,0,0,0,0,0,0,0,0,0,0,0,0,0,0,0,0,1,1},
  {0,0,0,0,0,0,0,0,0,0,0,0,0,0,0,0,0,0,1,1},
  {0,0,0,0,0,0,0,0,0,0,0,0,0,0,0,0,0,0,1,1},
  {0,0,0,0,0,0,0,0,0,0,0,0,0,0,0,0,0,0,1,1},
  {0,0,0,0,0,0,0,0,0,0,0,0,0,0,0,0,0,0,1,1},
  {0,0,0,0,0,0,0,0,0,0,0,0,0,0,0,3,3,3,1,1},
  {0,0,0,0,0,0,0,0,0,0,0,0,0,0,0,0,0,0,1,1},
  {0,0,0,0,0,0,0,0,0,0,0,0,0,0,0,0,0,0,1,1},
  {0,0,0,0,0,0,0,0,0,0,0,0,0,0,0,0,0,0,1,1},
  {0,0,0,0,0,0,0,0,0,0,0,0,0,0,0,0,0,0,1,1},
  {0,0,0,0,0,0,0,0,0,0,0,0,0,0,0,0,0,0,1,1},
  {0,0,0,0,0,0,0,0,0,0,0,0,0,0,0,0,0,0,1,1},
  {0,0,0,0,0,0,0,0,0,0,0,0,0,0,0,0,0,0,1,1},
  {0,0,0,0,0,0,0,0,0,0,0,0,0,0,0,0,0,0,1,1},
  {0,0,0,0,0,0,0,0,0,0,0,0,0,0,0,0,0,0,1,1},
  {0,0,0,0,0,0,0,0,0,0,0,0,0,0,0,0,0,0,1,1},
  {0,0,0,0,0,0,0,0,0,0,0,0,0,0,0,0,0,0,1,1},
  {0,0,0,0,0,0,0,0,0,0,0,0,0,0,0,0,0,0,1,1},
  {0,0,0,0,0,0,0,0,0,0,0,0,0,0,0,0,0,0,1,1},
  {0,0,0,0,0,0,0,0,1,1,1,1,1,1,1,1,1,1,1,1},
  {0,0,0,0,0,0,0,0,1,1,1,1,1,1,1,1,1,1,1,1},
  {0,0,0,0,0,0,0,0,0,0,0,0,0,0,0,0,0,0,1,1},
  {0,0,0,0,0,0,0,0,0,0,0,0,0,0,0,0,0,0,1,1},
  {0,0,0,0,0,0,0,0,0,0,0,0,0,0,0,0,0,0,1,1},
  {0,0,0,0,0,0,0,0,0,0,0,0,0,0,0,0,0,0,1,1},
  {0,0,0,0,0,0,0,0,0,0,0,0,0,0,0,0,0,0,1,1},
  {0,0,0,0,0,0,0,0,0,0,0,0,0,0,0,0,0,0,1,1},
  {0,0,0,0,0,0,0,0,0,0,0,0,0,0,0,0,0,0,1,1},
  {0,0,0,0,0,0,0,0,0,0,0,0,0,0,0,0,0,0,1,1},
  {0,0,0,0,0,0,0,0,0,0,0,0,0,0,0,0,0,0,1,1},
  {0,0,0,0,0,0,0,0,0,0,0,0,0,0,0,0,0,0,1,1},
  {0,0,0,0,0,0,0,0,0,0,0,0,0,0,0,0,0,0,1,1},
  {0,0,0,0,0,0,0,0,0,0,0,0,0,0,0,0,0,0,1,0},
  {0,0,0,0,0,0,0,0,0,0,0,0,0,0,0,0,0,0,0,0}
}