mapSize(32, 20)
start{x=24,y=11}
loadBG{
  {0,0,0,0,0,0,0,0,0,0,0,0,0,0,0,0,0,0,0,0},
  {0,0,0,0,0,0,0,0,0,0,0,0,0,0,0,0,0,0,0,0},
  {0,0,0,0,0,0,0,0,0,0,0,0,0,0,0,0,0,0,0,0},
  {0,0,0,0,0,0,0,0,0,0,0,0,0,0,0,0,0,0,0,0},
  {0,0,0,9,9,9,9,9,9,9,9,9,9,9,9,0,0,0,0,0},
  {0,0,0,10,10,10,10,10,10,10,10,10,10,10,10,0,0,0,0,0},
  {0,0,0,11,11,11,11,11,11,11,11,11,11,11,11,0,0,0,0,0},
  {0,0,0,0,0,0,0,0,0,0,0,0,0,0,0,0,0,0,0,0},
  {0,0,0,0,0,0,0,0,0,0,0,0,0,0,0,0,0,0,0,0},
  {0,0,0,9,9,9,9,9,9,9,9,9,0,0,0,0,0,0,0,0},
  {0,0,0,10,10,10,10,10,10,10,10,10,0,0,0,0,0,0,0,0},
  {0,0,0,11,11,11,11,11,11,11,11,11,0,0,0,0,0,0,0,0},
  {0,0,0,0,0,0,0,0,0,0,0,0,0,0,0,0,0,0,0,0},
  {0,0,0,0,0,0,0,0,0,0,0,0,0,0,0,0,0,0,0,0},
  {0,0,0,0,0,0,0,0,0,0,0,0,0,0,0,0,0,0,0,0},
  {0,0,0,0,0,0,0,0,0,0,0,9,9,9,9,9,9,9,9,9},
  {0,0,0,9,9,9,9,9,9,0,0,10,10,10,10,10,10,10,10,10},
  {0,0,0,10,10,10,10,10,10,0,0,11,11,11,11,11,11,11,11,11},
  {0,0,0,11,11,11,11,11,11,0,0,0,0,0,0,0,0,0,0,0},
  {0,0,0,0,0,0,0,0,0,0,0,0,0,0,0,0,0,0,0,0},
  {0,0,0,0,0,0,0,0,0,0,0,0,0,0,0,0,0,0,0,0},
  {0,0,0,0,0,0,0,0,0,0,0,0,0,0,0,0,0,0,0,0},
  {0,0,0,0,0,0,0,0,0,0,0,0,0,0,0,0,0,0,0,0},
  {0,0,0,0,0,0,0,0,0,0,0,0,0,0,0,0,0,0,0,0},
  {0,0,0,0,0,0,0,0,0,0,0,0,0,0,0,0,0,0,0,0},
  {0,0,0,0,0,0,0,0,0,0,0,0,0,0,0,0,0,0,0,0},
  {0,0,0,0,0,0,0,0,0,0,0,0,0,0,0,0,0,0,0,0},
  {0,0,0,0,0,0,0,0,0,0,0,0,0,0,0,0,0,0,0,0},
  {0,0,0,0,0,0,0,0,0,0,0,0,0,0,0,0,0,0,0,0},
  {0,0,0,0,0,0,0,0,9,9,9,9,9,9,9,9,9,9,9,9},
  {0,0,0,0,0,0,0,0,10,10,10,10,10,10,10,10,10,10,10,10},
  {0,0,0,0,0,0,0,0,11,11,11,11,11,11,11,11,11,11,11,11}
}
loadFG{
  {0,0,0,0,0,0,0,0,0,0,0,0,0,0,0,0,0,0,0,0},
  {0,0,0,0,0,0,0,0,0,0,0,0,0,0,0,0,0,0,0,0},
  {0,0,0,0,0,0,0,0,0,0,0,0,0,0,0,0,0,0,0,0},
  {0,0,0,0,0,0,0,0,0,0,0,0,0,0,0,0,0,0,0,0},
  {0,0,0,0,0,0,0,0,0,0,0,0,0,0,0,0,0,0,0,0},
  {0,0,0,0,0,0,0,0,0,0,0,0,0,0,0,0,0,0,0,0},
  {0,0,0,0,0,0,0,0,0,0,0,0,0,0,0,0,0,0,0,0},
  {0,0,0,0,0,0,0,0,0,0,0,0,0,0,0,0,0,0,0,0},
  {0,0,0,0,0,0,0,0,0,0,0,0,0,0,0,0,0,0,0,0},
  {0,0,0,0,0,0,0,0,0,0,0,0,0,0,0,0,0,0,0,0},
  {0,0,0,0,0,0,0,0,0,0,0,0,0,0,0,0,0,0,0,0},
  {0,0,0,0,0,0,0,0,0,0,0,0,0,0,0,0,0,0,0,0},
  {0,0,0,0,0,0,0,0,0,0,0,0,0,0,0,0,0,0,0,0},
  {0,0,0,0,0,0,0,0,0,0,0,0,0,0,0,0,0,0,0,0},
  {0,0,0,0,0,0,0,0,0,0,0,0,0,0,0,0,0,0,0,0},
  {0,0,0,0,0,0,0,0,0,0,0,0,0,0,0,0,0,0,0,0},
  {0,0,0,0,0,0,0,0,0,0,0,0,0,0,0,0,0,0,0,0},
  {0,0,0,0,0,0,0,0,0,0,0,0,0,0,0,0,0,0,0,0},
  {0,0,0,0,0,0,0,0,0,0,0,0,0,0,0,0,0,0,0,0},
  {0,0,0,0,0,0,0,0,0,0,0,0,0,0,0,0,0,0,0,0},
  {0,0,0,0,0,0,0,0,0,0,0,0,0,0,0,0,0,0,0,0},
  {0,0,0,0,0,0,0,0,0,0,0,0,0,0,0,0,0,0,0,0},
  {0,0,0,0,0,0,0,0,0,0,0,0,0,0,0,0,0,0,0,0},
  {0,0,0,0,0,0,0,0,0,0,0,0,0,0,0,0,0,0,0,0},
  {0,0,0,0,0,0,0,0,0,0,0,0,0,0,0,0,0,0,0,0},
  {0,0,0,0,0,0,0,0,0,0,0,0,0,0,0,0,0,0,0,0},
  {0,0,0,0,0,0,0,0,0,0,0,0,0,0,0,0,0,0,0,0},
  {0,0,0,0,0,0,0,0,0,0,0,0,0,0,0,0,0,0,0,0},
  {0,0,0,0,0,0,0,0,0,0,0,0,0,0,0,0,0,0,0,0},
  {0,0,0,0,0,0,0,0,0,0,0,0,0,0,0,0,0,0,0,0},
  {0,0,0,0,0,0,0,0,0,0,0,0,0,0,0,0,0,0,0,0},
  {0,0,0,0,0,0,0,0,0,0,0,0,0,0,0,0,0,0,0,0}
}
loadOBJ{
  {0,0,0,0,0,0,0,0,0,0,0,0,0,0,0,0,0,0,0,0},
  {0,0,0,0,0,0,0,0,0,0,0,0,0,0,0,0,0,0,0,0},
  {0,0,0,0,0,0,0,0,0,0,0,0,0,0,0,0,0,0,0,0},
  {0,0,0,0,0,0,0,0,0,0,0,0,0,0,0,0,0,0,0,0},
  {0,0,0,0,0,0,0,0,0,0,0,0,0,0,0,0,0,0,0,0},
  {0,0,0,0,0,0,0,0,0,0,10,0,0,0,0,0,0,0,0,0},
  {0,0,0,0,0,0,0,0,0,0,0,0,0,0,0,0,0,0,0,0},
  {0,0,0,0,0,0,0,0,0,0,0,0,0,0,0,0,0,0,0,0},
  {0,0,0,0,0,0,0,0,0,0,0,0,0,0,0,0,0,0,0,0},
  {0,0,0,0,0,0,0,0,0,0,0,0,0,0,0,0,0,0,0,0},
  {0,0,0,0,0,0,0,0,10,0,0,0,0,0,0,0,0,0,0,0},
  {0,0,0,0,0,0,0,0,0,0,0,0,0,0,0,0,0,0,0,0},
  {0,0,0,0,0,0,0,0,0,0,0,0,0,0,0,0,0,0,0,0},
  {0,0,0,0,0,0,0,0,0,0,0,0,0,0,0,0,0,0,0,0},
  {0,0,0,0,0,0,0,0,0,0,0,0,0,0,0,0,0,0,0,0},
  {0,0,0,0,0,0,0,0,0,0,0,0,0,0,0,0,0,0,0,0},
  {0,0,0,0,0,0,0,0,0,0,0,0,0,14,0,0,10,0,0,0},
  {0,0,0,0,0,0,0,10,0,0,0,0,0,0,0,0,0,0,0,0},
  {0,0,0,0,0,0,0,0,0,0,0,0,0,0,0,0,0,0,0,0},
  {0,0,0,0,0,0,0,0,0,0,0,0,0,0,0,0,0,0,0,0},
  {0,0,0,0,0,0,0,0,0,0,0,0,0,0,0,0,0,0,0,0},
  {0,0,0,0,0,0,0,0,0,0,0,0,0,0,0,0,0,0,0,0},
  {0,0,0,0,0,0,0,0,0,0,0,0,0,0,0,0,0,0,0,0},
  {0,0,0,0,0,0,0,9,0,0,0,0,0,0,0,0,0,0,0,0},
  {0,0,0,0,0,0,0,0,0,0,0,0,0,0,0,0,0,0,0,0},
  {0,0,0,0,0,0,0,0,0,0,0,0,0,0,0,0,0,0,0,0},
  {0,0,0,0,0,0,0,0,0,0,0,0,0,0,0,0,0,0,0,0},
  {0,0,0,0,0,0,0,0,0,0,0,0,0,0,0,0,0,0,0,0},
  {0,0,0,0,0,0,0,0,0,0,0,0,0,0,0,0,0,0,0,0},
  {0,0,0,0,0,2,0,0,0,0,0,0,0,0,0,0,0,0,0,0},
  {0,0,0,0,0,0,0,0,0,0,0,0,0,0,0,0,10,0,0,0},
  {0,0,0,0,0,0,0,0,0,0,0,0,0,0,0,0,0,0,0,0}
}
loadWall{
  {18,18,18,18,19,19,19,19,19,19,19,19,19,19,19,19,19,19,19,18},
  {18,18,18,26,0,0,0,0,0,0,0,0,0,0,0,0,0,0,0,10},
  {18,18,18,26,0,0,0,0,0,0,0,0,0,0,0,0,0,0,0,10},
  {18,18,18,26,0,0,0,0,0,0,0,0,0,0,9,17,17,25,0,10},
  {18,18,18,26,0,0,0,0,0,0,0,0,0,0,10,18,18,26,0,10},
  {18,18,18,26,0,0,0,0,0,0,0,0,0,0,10,18,18,26,0,10},
  {18,18,18,26,0,0,0,0,0,0,0,0,0,0,10,18,18,27,0,10},
  {18,18,18,26,0,0,0,0,0,0,0,0,0,0,10,18,27,0,0,10},
  {18,18,18,26,0,0,0,0,0,0,0,0,0,0,10,26,0,0,0,10},
  {18,18,18,26,0,0,0,0,0,0,0,9,17,17,18,26,0,0,0,10},
  {18,18,18,26,0,0,0,0,0,0,0,10,18,18,18,27,0,0,0,10},
  {18,18,18,26,0,0,0,0,0,0,0,10,18,18,26,0,0,0,0,10},
  {18,18,18,26,0,0,0,0,0,0,0,10,18,18,26,0,0,0,0,10},
  {18,18,18,26,0,0,0,0,0,0,0,10,19,19,27,0,0,0,0,10},
  {18,18,18,26,0,0,0,0,0,0,9,26,0,0,0,0,0,0,0,10},
  {18,18,18,26,0,0,0,0,0,0,10,26,0,0,0,0,0,0,0,10},
  {18,18,18,26,0,0,0,0,9,17,18,26,0,0,0,0,0,0,0,10},
  {18,18,18,26,0,0,0,0,10,18,18,26,0,0,0,0,0,0,0,10},
  {18,18,18,26,0,0,0,0,10,18,18,26,0,0,0,0,0,0,0,10},
  {18,18,18,26,0,0,9,17,18,18,18,26,0,0,0,0,0,0,0,10},
  {18,18,18,26,0,0,10,18,18,18,18,26,0,0,0,0,0,0,0,10},
  {18,18,18,26,0,0,11,19,18,19,19,26,0,0,0,0,0,0,0,10},
  {18,18,18,26,0,0,0,0,2,0,0,2,0,0,0,0,0,0,0,10},
  {18,18,18,26,0,0,0,0,2,0,0,2,0,0,0,0,0,0,0,10},
  {18,18,18,26,0,0,0,0,2,0,0,2,0,0,0,0,0,0,0,10},
  {18,18,18,26,0,0,0,0,2,0,0,3,0,0,0,0,0,0,0,10},
  {18,18,18,26,0,0,0,0,2,0,0,0,0,0,0,0,0,0,0,10},
  {18,18,18,19,28,0,0,0,2,0,0,0,0,0,0,0,0,0,0,10},
  {18,18,26,0,0,0,0,0,2,0,0,0,0,0,0,0,0,0,0,10},
  {18,18,26,0,0,0,9,17,18,20,20,20,20,20,20,20,20,20,20,18},
  {18,18,26,0,0,0,10,18,26,0,0,0,0,0,0,0,0,0,0,10},
  {18,18,18,17,17,17,18,18,18,17,17,17,17,17,17,17,17,17,17,18}
}
loadCollision{
  {1,1,1,1,1,1,1,1,1,1,1,1,1,1,1,1,1,1,1,1},
  {1,1,1,1,0,0,0,0,0,0,0,0,0,0,0,0,0,0,0,1},
  {1,1,1,1,0,0,0,0,0,0,0,0,0,0,0,0,0,0,0,1},
  {1,1,1,1,0,0,0,0,0,0,0,0,0,0,1,1,1,1,0,1},
  {1,1,1,1,0,0,0,0,0,0,0,0,0,0,1,1,1,1,0,1},
  {1,1,1,1,0,0,0,0,0,0,0,0,0,0,1,1,1,1,0,1},
  {1,1,1,1,0,0,0,0,0,0,0,0,0,0,1,1,1,1,0,1},
  {1,1,1,1,0,0,0,0,0,0,0,0,0,0,1,1,1,0,0,1},
  {1,1,1,1,0,0,0,0,0,0,0,0,0,0,1,1,0,0,0,1},
  {1,1,1,1,0,0,0,0,0,0,0,1,1,1,1,1,0,0,0,1},
  {1,1,1,1,0,0,0,0,0,0,0,1,1,1,1,1,0,0,0,1},
  {1,1,1,1,0,0,0,0,0,0,0,1,1,1,1,0,0,0,0,1},
  {1,1,1,1,0,0,0,0,0,0,0,1,1,1,1,0,0,0,0,1},
  {1,1,1,1,0,0,0,0,0,0,0,1,1,1,1,0,0,0,0,1},
  {1,1,1,1,0,0,0,0,0,0,1,1,0,0,0,0,0,0,0,1},
  {1,1,1,1,0,0,0,0,0,0,1,1,0,0,0,0,0,0,0,1},
  {1,1,1,1,0,0,0,0,1,1,1,1,0,0,0,0,0,0,0,1},
  {1,1,1,1,0,0,0,0,1,1,1,1,0,0,0,0,0,0,0,1},
  {1,1,1,1,0,0,0,0,1,1,1,1,0,0,0,0,0,0,0,1},
  {1,1,1,1,0,0,1,1,1,1,1,1,0,0,0,0,0,0,0,1},
  {1,1,1,1,0,0,1,1,1,1,1,1,0,0,0,0,0,0,0,1},
  {1,1,1,1,0,0,1,1,1,1,1,1,0,0,0,0,0,0,0,1},
  {1,1,1,1,0,0,0,0,1,0,0,1,0,0,0,0,0,0,0,1},
  {1,1,1,1,0,0,0,0,1,0,0,1,0,0,0,0,0,0,0,1},
  {1,1,1,1,0,0,0,0,1,0,0,1,0,0,0,0,0,0,0,1},
  {1,1,1,1,0,0,0,0,1,0,0,1,0,0,0,0,0,0,0,1},
  {1,1,1,1,0,0,0,0,1,0,0,0,0,0,0,0,0,0,0,1},
  {1,1,1,1,1,0,0,0,1,0,0,0,0,0,0,0,0,0,0,1},
  {1,1,1,0,0,0,0,0,1,0,0,0,0,0,0,0,0,0,0,1},
  {1,1,1,0,0,0,1,1,1,1,1,1,1,1,1,1,1,1,1,1},
  {1,1,1,0,0,0,1,1,1,0,0,0,0,0,0,0,0,0,0,1},
  {1,1,1,1,1,1,1,1,1,1,1,1,1,1,1,1,1,1,1,1}
}
