{25,25,25,25,25,25,25,25,25,25,25,25,25,25,25,25,25,25,25,25,25,25,25,25,25,25,25,25,25,25,25,25,25,25,25,25,25,25,25,25,25,25,25,25,25},
{25,25,25,25,25,25,25,25,25,25,25,25,25,25,25,25,25,25,25,25,25,25,25,25,25,25,25,25,25,25,25,25,25,25,25,25,25,25,25,25,25,25,25,25,25},
{25,25,25,25,25,25,25,25,25,25,25,25,25,25,25,25,25,25,25,25,25,25,25,25,25,25,25,25,25,25,25,25,25,25,25,25,25,25,25,25,25,25,25,25,25},
{25,25,25,25,25,25,25,25,25,25,25,25,25,25,25,25,25,25,25,25,25,1,2,2,2,2,2,2,2,2,2,2,2,2,2,2,2,3,25,25,25,25,25,25,25},
{25,25,25,25,25,25,25,25,25,25,25,25,25,25,25,25,25,25,25,25,25,7,5,5,5,5,5,5,5,5,5,5,5,5,5,5,5,9,25,25,25,25,25,25,25},
{25,25,25,25,25,25,25,25,25,25,25,25,25,25,25,25,25,25,25,25,25,7,6,0,0,0,0,0,0,0,0,0,0,0,0,0,4,9,25,25,25,25,25,25,25},
{25,25,25,25,25,25,25,25,25,25,25,25,25,25,25,25,25,25,25,25,25,7,6,0,0,0,0,0,0,0,0,0,0,0,0,0,4,21,22,2,2,3,25,25,25},
{25,25,25,25,25,25,25,25,25,25,25,25,25,25,25,25,25,25,25,1,19,20,6,0,0,0,0,0,0,0,0,0,0,0,0,0,4,5,5,5,5,9,25,25,25},
{25,25,25,25,25,25,25,25,25,25,25,25,25,25,25,25,25,1,19,8,8,8,6,0,0,0,0,0,0,0,0,0,10,0,0,0,0,0,0,0,4,9,25,25,25},
{25,25,25,25,25,25,25,25,25,25,25,25,25,25,25,25,25,7,8,8,8,8,6,0,0,0,0,0,0,0,0,0,10,0,0,0,0,0,0,0,4,9,25,25,25},
{25,25,25,25,25,25,25,25,25,25,25,25,25,25,25,25,25,13,14,26,4,8,5,5,5,5,5,5,5,5,5,5,5,5,5,5,5,6,0,0,4,9,25,25,25},
{25,25,25,25,25,25,25,25,25,25,25,25,25,25,25,25,25,25,25,25,25,13,14,14,14,14,14,14,14,14,14,14,14,14,14,14,26,6,0,0,4,9,25,25,25},
{25,25,25,25,25,25,25,25,25,25,25,25,25,25,25,25,25,25,25,25,25,25,25,25,25,25,25,25,25,25,25,25,25,25,25,25,7,6,0,0,4,9,25,25,25},
{25,25,25,25,25,25,25,25,25,25,25,25,25,25,25,25,25,25,25,25,25,25,25,25,25,25,25,25,25,25,25,25,25,25,25,25,7,6,0,0,4,9,25,25,25},
{25,25,25,25,25,25,25,25,25,25,25,25,25,25,25,25,25,25,25,25,25,25,25,25,25,25,25,25,25,25,25,25,25,25,25,25,7,6,0,0,4,9,25,25,25},
{25,25,25,25,25,25,25,25,25,25,25,25,25,25,25,25,25,25,25,25,25,25,25,25,25,25,25,25,25,25,1,2,2,3,25,25,7,6,0,0,4,9,25,25,25},
{25,25,25,25,25,25,25,25,25,25,25,25,25,25,25,1,2,2,2,2,2,2,2,2,2,2,2,3,25,25,11,0,0,12,25,25,7,6,0,0,4,9,25,25,25},
{25,25,25,25,25,25,25,25,25,25,25,25,25,25,25,7,8,8,8,8,8,8,8,8,8,8,8,9,25,25,11,0,0,12,25,25,7,6,0,0,4,9,25,25,25},
{25,25,25,25,25,25,25,25,25,25,25,25,25,25,25,7,6,0,0,0,0,0,0,0,0,0,4,9,25,25,11,0,0,12,25,25,7,6,0,0,4,9,25,25,25},
{25,25,25,25,25,25,25,25,25,25,25,25,25,25,25,7,6,0,0,0,0,0,0,0,0,0,4,9,25,25,11,0,0,12,25,25,7,6,0,0,4,9,25,25,25},
{25,25,25,25,25,25,25,25,25,25,25,25,25,25,25,7,6,0,0,0,0,0,0,0,0,0,4,9,25,25,11,0,27,15,25,25,7,6,0,0,4,9,25,25,25},
{25,25,25,25,25,25,25,25,25,25,25,25,25,25,16,7,6,0,0,0,0,0,0,0,0,0,4,9,25,25,11,0,12,25,25,25,7,6,0,0,4,9,25,25,25},
{25,25,25,25,25,25,25,25,25,25,25,25,25,25,7,8,6,0,0,0,0,0,0,0,0,0,4,9,25,25,11,0,12,25,25,25,7,6,0,0,4,9,25,25,25},
{25,25,25,25,25,25,25,25,25,25,25,25,25,25,7,8,6,0,0,0,0,0,0,0,0,0,4,21,22,19,20,0,21,22,2,19,20,6,0,0,4,9,25,25,25},
{25,25,25,25,25,25,25,25,25,25,25,25,25,25,7,8,6,0,0,4,17,17,17,6,0,0,4,5,5,5,5,0,5,5,5,5,5,6,0,0,4,9,25,25,25},
{25,25,25,25,25,25,25,25,25,25,25,25,25,25,7,8,6,0,0,0,0,0,0,0,0,0,0,0,0,0,0,0,0,0,0,0,0,0,0,0,4,9,25,25,25},
{25,25,25,25,25,25,25,25,25,25,25,25,25,25,7,8,6,0,0,0,0,0,0,0,0,0,0,0,0,0,0,0,0,0,0,0,0,0,0,0,4,9,25,25,25},
{25,25,25,25,25,25,25,25,25,25,25,25,25,25,13,14,26,17,17,17,17,17,17,17,17,17,17,17,17,17,17,17,17,17,17,17,17,17,17,17,5,9,25,25,25},
{25,25,25,25,25,25,25,25,25,25,25,25,25,25,25,25,31,13,14,14,14,14,14,14,14,14,14,14,14,14,14,14,14,14,14,14,14,14,14,14,14,15,25,25,25},
{25,25,25,25,25,25,25,25,25,25,25,25,25,25,25,25,25,25,25,25,25,25,25,25,25,25,25,25,25,25,25,25,25,25,25,25,25,25,25,25,25,25,25,25,25}
