data = {
{29,29,29,29,29,29,29,29,29,29,29,29,29,29,29,29,29,29,29,29,29,29,29,29,29,29,29,29,29,29,29,29,29,29,29,29,29,29,29,29,29,29,29,29,29,29,29,29,29,29,29,29,29,29,29,29,29,29,29,29},
{29,29,29,29,29,29,29,29,29,29,29,29,29,29,29,29,29,29,29,29,29,29,29,29,29,29,29,29,29,29,29,29,29,29,29,29,29,29,29,29,29,29,29,29,29,29,29,29,29,29,29,29,29,29,29,29,29,29,29,29},
{29,29,29,29,29,29,29,29,29,29,29,29,29,29,29,29,29,29,29,29,29,29,29,29,29,29,29,29,29,29,29,29,29,29,29,29,29,29,29,29,29,29,29,29,29,29,29,29,29,29,29,29,29,29,29,29,29,29,29,29},
{29,29,29,29,29,29,29,29,29,29,29,29,29,29,29,29,29,29,29,29,29,29,29,29,29,29,29,29,29,29,29,29,29,29,29,29,29,29,29,29,29,29,29,29,29,29,29,29,29,29,29,29,29,29,29,29,29,29,29,29},
{29,29,29,29,29,29,29,29,29,29,29,29,29,29,29,29,29,29,29,29,29,29,29,29,29,29,29,29,29,29,29,29,29,29,29,29,29,29,29,29,29,29,29,29,29,29,29,29,29,29,29,29,29,29,29,29,29,29,29,29},
{29,29,29,29,29,29,29,29,29,29,29,29,29,29,29,29,29,29,29,29,29,29,29,29,29,29,29,29,29,29,29,29,29,29,29,29,29,29,29,29,29,29,29,29,29,29,29,29,29,29,29,29,29,29,29,29,29,29,29,29},
{29,29,29,29,29,29,29,29,29,29,29,29,29,29,29,29,29,29,29,29,29,29,29,29,29,29,29,29,29,29,29,29,29,29,29,29,29,29,29,29,29,29,29,29,29,29,29,29,29,29,29,29,29,29,29,29,29,29,29,29},
{29,29,29,29,29,29,29,29,29,29,29,29,29,29,29,29,29,29,29,29,29,29,29,29,29,29,29,29,29,29,29,29,29,29,29,29,29,29,29,29,29,29,29,29,29,29,29,29,29,29,29,29,29,29,29,29,29,29,29,29},
{29,29,29,29,29,29,29,29,29,29,29,29,29,29,29,29,29,29,29,29,29,29,29,29,29,29,29,29,29,29,29,29,29,29,29,29,29,29,29,29,29,29,29,29,29,29,29,29,29,29,29,29,29,29,29,29,29,29,29,29},
{29,29,29,29,29,29,29,29,29,29,29,29,29,29,29,29,29,29,29,29,29,29,48,40,40,40,40,40,40,40,40,40,40,40,40,40,40,40,40,47,28,23,29,48,17,17,17,17,17,17,17,17,17,17,47,29,29,29,29,29},
{29,29,29,29,29,29,29,29,29,29,29,29,29,29,29,29,29,29,29,29,29,29,30,0,0,0,0,0,0,0,0,0,0,0,0,0,0,0,0,27,23,23,29,30,0,0,0,0,0,0,0,0,0,0,27,29,29,29,29,29},
{29,29,29,29,29,29,29,29,29,29,29,29,29,29,29,29,29,29,29,29,29,29,30,0,0,0,0,0,0,0,0,0,0,0,0,0,0,0,0,27,23,29,29,30,0,0,0,0,0,0,0,0,0,0,27,29,29,29,29,29},
{29,29,29,29,29,29,29,29,29,29,29,29,29,29,29,29,29,29,29,29,29,29,30,0,0,0,0,0,0,0,0,0,0,0,0,0,0,0,0,27,23,23,23,30,0,0,0,0,0,0,0,0,0,0,27,29,29,1,29,29},
{29,29,29,29,29,29,29,29,29,29,29,29,29,29,29,29,29,29,29,29,29,29,30,0,0,0,0,0,0,0,0,0,0,0,0,0,0,0,0,15,17,17,17,18,0,0,0,0,0,0,0,0,0,0,27,29,29,1,29,29},
{29,29,29,29,29,29,29,29,29,29,29,29,29,29,29,29,29,29,29,29,29,29,30,0,0,0,0,0,0,0,0,0,0,0,0,0,0,0,0,0,0,0,0,0,0,0,0,0,0,0,0,0,0,0,27,29,29,1,29,29},
{29,29,29,29,29,29,29,29,29,29,29,29,29,29,29,29,29,29,29,29,29,29,30,0,0,0,0,0,0,0,0,0,0,0,0,0,0,0,0,9,10,10,10,12,0,0,0,0,0,0,0,0,0,0,27,29,1,1,29,29},
{29,29,29,29,29,29,29,29,29,29,29,29,29,29,29,29,29,29,29,29,29,29,30,0,0,0,0,0,0,0,0,0,0,0,0,0,0,0,0,27,29,29,29,30,0,0,0,0,0,0,0,0,0,0,27,29,1,29,29,29},
{29,29,29,29,29,29,29,29,29,29,29,29,29,29,29,29,29,29,29,29,29,29,30,0,0,0,0,0,0,0,0,0,0,0,0,0,0,0,0,27,29,29,29,30,0,0,0,0,0,0,0,0,0,0,27,29,29,29,29,29},
{29,29,29,29,29,29,29,29,29,29,29,29,29,29,29,29,29,29,29,29,29,29,30,0,0,0,0,0,0,0,0,0,0,0,0,0,0,0,0,27,29,29,29,30,0,0,0,0,0,0,0,0,0,0,27,29,29,29,29,29},
{29,29,29,29,29,29,29,29,29,29,29,29,29,29,29,29,29,29,29,29,48,16,18,0,0,0,0,0,0,0,0,0,0,0,0,0,0,0,0,27,29,29,29,44,10,10,10,10,10,10,10,10,10,10,43,29,29,29,29,29},
{29,29,29,29,29,29,29,29,29,29,29,29,29,29,29,29,29,29,29,29,30,0,0,0,0,0,0,0,0,0,0,0,0,0,0,0,0,0,0,27,29,29,29,29,29,29,29,29,29,29,29,29,29,29,29,29,29,29,29,29},
{29,29,29,29,29,29,29,29,29,29,29,29,29,29,29,29,29,29,29,29,30,0,0,0,0,0,0,0,0,0,0,0,0,0,0,0,0,0,0,27,29,29,29,29,29,29,29,29,29,29,29,29,29,29,29,29,29,29,29,29},
{29,29,29,29,29,29,29,29,29,29,29,29,29,29,29,29,29,29,29,29,30,0,0,0,0,0,0,0,0,0,0,0,0,0,0,0,0,0,0,27,29,29,29,29,29,29,29,29,29,29,29,29,29,29,29,29,29,29,29,29},
{29,29,29,29,29,29,29,29,29,29,29,29,29,29,29,29,29,29,29,29,30,0,0,0,0,0,0,0,0,0,0,0,0,0,0,0,0,0,0,27,29,29,29,29,29,29,29,29,29,29,29,29,29,29,29,29,29,29,29,29},
{29,29,29,29,29,29,29,29,29,29,29,29,29,29,29,29,29,29,29,29,30,0,0,0,0,0,0,0,0,0,0,0,0,0,0,0,0,0,0,27,29,29,29,29,29,29,29,29,29,29,29,29,29,29,29,29,29,29,29,29},
{29,29,29,29,29,29,29,29,29,29,29,29,29,29,29,29,29,29,29,29,30,0,0,0,0,0,0,0,0,0,0,0,0,0,0,0,0,0,0,27,29,29,29,29,29,29,29,29,29,29,29,29,29,29,29,29,29,29,29,29},
{29,29,29,29,29,29,29,29,29,29,29,29,29,29,29,29,29,29,29,29,30,0,0,0,0,0,0,0,0,0,0,0,0,0,0,0,0,0,0,27,29,29,29,29,29,29,29,29,29,29,29,29,29,29,29,29,29,29,29,29},
{29,29,29,29,29,29,29,29,29,29,29,29,29,29,29,29,29,29,29,29,30,0,0,0,0,0,3,4,5,5,4,5,6,0,0,0,0,0,0,27,29,29,29,29,29,29,29,29,29,29,29,29,29,29,29,29,29,29,29,29},
{29,29,29,29,29,29,29,29,29,29,29,29,29,29,29,29,29,29,29,29,30,0,0,0,0,0,0,25,0,0,0,25,0,0,0,0,0,0,0,27,29,29,29,29,29,29,29,29,29,29,29,29,29,29,29,29,29,29,29,29},
{29,29,29,29,29,29,29,29,29,29,29,29,29,29,29,29,29,29,29,29,30,0,0,0,0,0,0,31,0,0,0,31,0,0,0,0,0,0,0,27,29,29,29,29,29,29,29,29,29,29,29,29,29,29,29,29,29,29,29,29},
{29,29,29,29,29,29,29,29,29,29,29,29,29,29,29,29,29,29,29,29,30,0,0,0,0,0,0,31,0,0,0,31,0,0,0,0,0,0,0,27,29,29,29,29,29,29,29,29,29,29,29,29,29,29,29,29,29,29,29,29},
{29,29,29,29,29,29,29,29,29,29,29,29,29,29,29,29,29,29,29,29,30,0,0,0,0,0,0,31,0,0,0,31,0,0,0,0,0,0,0,27,29,29,29,29,29,29,29,29,29,29,29,29,29,29,29,29,29,29,29,29},
{29,29,29,29,29,29,29,29,29,29,29,29,29,29,29,29,29,29,29,29,30,0,0,0,0,0,0,37,0,0,0,37,0,0,0,0,0,0,0,27,29,29,29,29,29,29,29,29,29,29,29,29,29,29,29,29,29,29,29,29},
{29,29,29,29,29,29,29,29,29,29,29,29,29,29,29,29,29,29,29,29,44,10,10,10,10,10,10,10,10,10,10,10,10,10,10,10,10,10,10,43,29,29,29,29,29,29,29,29,29,29,29,29,29,29,29,29,29,29,29,29},
{29,29,29,29,29,29,29,29,29,29,29,29,29,29,29,29,29,29,29,29,29,29,29,29,29,29,29,29,29,29,29,29,29,29,29,29,29,29,29,29,29,29,29,29,29,29,29,29,29,29,29,29,29,29,29,29,29,29,29,29},
{29,29,29,29,29,29,29,29,29,29,29,29,29,29,29,29,29,29,29,29,29,29,29,29,29,29,29,29,29,29,29,29,29,29,29,29,29,29,29,29,29,29,29,29,29,29,29,29,29,29,29,29,29,29,29,29,29,29,29,29},
{29,29,29,29,29,29,29,29,29,29,29,29,29,29,29,29,29,29,29,29,29,29,29,29,29,29,29,29,29,29,29,29,29,29,29,29,29,29,29,29,29,29,29,29,29,29,29,29,29,29,29,29,29,29,29,29,29,29,29,29},
{29,29,29,29,29,29,29,29,29,29,29,29,29,29,29,29,29,29,29,29,29,29,29,29,29,29,29,29,29,29,29,29,29,29,29,29,29,29,29,29,29,29,29,29,29,29,29,29,29,29,29,29,29,29,29,29,29,29,29,29},
{29,29,29,29,29,29,29,29,29,29,29,29,29,29,29,29,29,29,29,29,29,29,29,29,29,29,29,29,29,29,29,29,29,29,29,29,29,29,29,29,29,29,29,29,29,29,29,29,29,29,29,29,29,29,29,29,29,29,29,29},
{29,29,29,29,29,29,29,29,29,29,29,29,29,29,29,29,29,29,29,29,29,29,29,29,29,29,29,29,29,29,29,29,29,29,29,29,29,29,29,29,29,29,29,29,29,29,29,29,29,29,29,29,29,29,29,29,29,29,29,29},
{29,29,29,29,29,29,29,29,29,29,29,29,29,29,29,29,29,29,29,29,29,29,29,29,29,29,29,29,29,29,29,29,29,29,29,29,29,29,29,29,29,29,29,29,29,29,29,29,29,29,29,29,29,29,29,29,29,29,29,29},
{29,29,29,29,29,29,29,29,29,29,29,29,29,29,29,29,29,29,29,29,29,29,29,29,29,29,29,29,29,29,29,29,29,29,29,29,29,29,29,29,29,29,29,29,29,29,29,29,29,29,29,29,29,29,29,29,29,29,29,29},
{29,29,29,29,29,29,29,29,29,29,29,29,29,29,29,29,29,29,29,29,29,29,29,29,29,29,29,29,29,29,29,29,29,29,29,29,29,29,29,29,29,29,29,29,29,29,29,29,29,29,29,29,29,29,29,29,29,29,29,29},
{29,29,29,29,29,29,29,29,29,29,29,29,29,29,29,29,29,29,29,29,29,29,29,29,29,29,29,29,29,29,29,29,29,29,29,29,29,29,29,29,29,29,29,29,29,29,29,29,29,29,29,29,29,29,29,29,29,29,29,29},
{29,29,29,29,29,29,29,29,29,29,29,29,29,29,29,29,29,29,29,29,29,29,29,29,29,29,29,29,29,29,29,29,29,29,29,29,29,29,29,29,29,29,29,29,29,29,29,29,29,29,29,29,29,29,29,29,29,29,29,29}
}
