mapSize(60, 45, 32)
imageFilename("tiles1.png")
loadTiles{
{29,29,29,29,29,29,29,29,29,29,29,29,29,29,29,29,29,29,29,29,29,29,29,29,29,29,29,29,29,29,29,29,29,29,29,29,29,29,29,29,29,29,29,29,29},
{29,29,29,29,29,29,29,29,29,29,29,29,29,29,29,29,29,29,29,29,29,29,29,29,29,29,29,29,29,29,29,29,29,29,29,29,29,29,29,29,29,29,29,29,29}, {29,29,29,29,29,29,29,29,29,29,29,29,29,29,29,29,29,29,29,29,29,29,29,29,29,29,29,29,29,29,29,29,29,29,29,29,29,29,29,29,29,29,29,29,29}, {29,29,29,29,29,29,29,29,29,29,29,29,29,29,29,29,29,29,29,29,29,29,29,29,29,29,29,29,29,29,29,29,29,29,29,29,29,29,29,29,29,29,29,29,29}, {29,29,29,29,29,29,29,29,29,29,29,29,29,29,29,29,29,29,29,29,29,29,29,29,29,29,29,29,29,29,29,29,29,29,29,29,29,29,29,29,29,29,29,29,29}, {29,29,29,29,29,29,29,29,29,29,29,29,29,29,29,29,29,29,29,29,29,29,29,29,29,29,29,29,29,29,29,29,29,29,29,29,29,29,29,29,29,29,29,29,29}, {29,29,29,29,29,29,29,29,29,29,29,29,29,29,29,29,29,29,29,29,29,29,29,29,29,29,29,29,29,29,29,29,29,29,29,29,29,29,29,29,29,29,29,29,29}, {29,29,29,29,29,29,29,29,29,29,29,29,29,29,29,29,29,29,29,29,29,29,29,29,29,29,29,29,29,29,29,29,29,29,29,29,29,29,29,29,29,29,29,29,29}, {29,29,29,29,29,29,29,29,29,29,29,29,29,29,29,29,29,29,29,29,29,29,29,29,29,29,29,29,29,29,29,29,29,29,29,29,29,29,29,29,29,29,29,29,29}, {29,29,29,29,29,29,29,29,29,29,29,29,29,29,29,29,29,29,29,29,29,29,29,29,29,29,29,29,29,29,29,29,29,29,29,29,29,29,29,29,29,29,29,29,29}, {29,29,29,29,29,29,29,29,29,29,29,29,29,29,29,29,29,29,29,29,29,29,29,29,29,29,29,29,29,29,29,29,29,29,29,29,29,29,29,29,29,29,29,29,29}, {29,29,29,29,29,29,29,29,29,29,29,29,29,29,29,29,29,29,29,29,29,29,29,29,29,29,29,29,29,29,29,29,29,29,29,29,29,29,29,29,29,29,29,29,29}, {29,29,29,29,29,29,29,29,29,29,29,29,29,29,29,29,29,29,29,29,29,29,29,29,29,29,29,29,29,29,29,29,29,29,29,29,29,29,29,29,29,29,29,29,29}, {29,29,29,29,29,29,29,29,29,29,29,29,29,29,29,29,29,29,29,29,29,29,29,29,29,29,29,29,29,29,29,29,29,29,29,29,29,29,29,29,29,29,29,29,29}, {29,29,29,29,29,29,29,29,29,29,29,29,29,29,29,29,29,29,29,29,29,29,29,29,29,29,29,29,29,29,29,29,29,29,29,29,29,29,29,29,29,29,29,29,29}, {29,29,29,29,29,29,29,29,29,29,29,29,29,29,29,29,29,29,29,29,29,29,29,29,29,29,29,29,29,29,29,29,29,29,29,29,29,29,29,29,29,29,29,29,29}, {29,29,29,29,29,29,29,29,29,29,29,29,29,29,29,29,29,29,29,29,29,29,29,29,29,29,29,29,29,29,29,29,29,29,29,29,29,29,29,29,29,29,29,29,29}, {29,29,29,29,29,29,29,29,29,29,29,29,29,29,29,29,29,29,29,29,29,29,29,29,29,29,29,29,29,29,29,29,29,29,29,29,29,29,29,29,29,29,29,29,29}, {29,29,29,29,29,29,29,29,29,29,29,29,29,29,29,29,29,29,29,29,29,29,29,29,29,29,29,29,29,29,29,29,29,29,29,29,29,29,29,29,29,29,29,29,29}, {29,29,29,29,29,29,29,29,29,29,29,29,29,29,29,29,29,29,29,29,29,29,29,29,29,29,29,29,29,29,29,29,29,29,29,29,29,29,29,29,29,29,29,29,29}, {29,29,29,29,29,29,29,29,29,29,29,29,29,29,29,29,29,29,29,48,30,30,30,30,30,30,30,30,30,30,30,30,30,44,29,29,29,29,29,29,29,29,29,29,29},
{29,29,29,29,29,29,29,29,29,29,29,29,29,29,29,29,29,29,29,16,0,0,0,0,0,0,0,0,0,0,0,0,0,10,29,29,29,29,29,29,29,29,29,29,29},
{29,29,29,29,29,29,29,29,29,48,30,30,30,30,30,30,30,30,30,18,0,0,0,0,0,0,0,0,0,0,0,0,0,10,29,29,29,29,29,29,29,29,29,29,29},
{29,29,29,29,29,29,29,29,29,40,0,0,0,0,0,0,0,0,0,0,0,0,0,0,0,0,0,0,0,0,0,0,0,10,29,29,29,29,29,29,29,29,29,29,29},
{29,29,29,29,29,29,29,29,29,40,0,0,0,0,0,0,0,0,0,0,0,0,0,0,0,0,0,0,0,0,0,0,0,10,29,29,29,29,29,29,29,29,29,29,29},
{29,29,29,29,29,29,29,29,29,40,0,0,0,0,0,0,0,0,0,0,0,0,0,0,0,0,0,0,0,0,0,0,0,10,29,29,29,29,29,29,29,29,29,29,29},
{29,29,29,29,29,29,29,29,29,40,0,0,0,0,0,0,0,0,0,0,0,0,0,0,0,0,0,3,0,0,0,0,0,10,29,29,29,29,29,29,29,29,29,29,29},
{29,29,29,29,29,29,29,29,29,40,0,0,0,0,0,0,0,0,0,0,0,0,0,0,0,0,0,4,25,31,31,31,37,10,29,29,29,29,29,29,29,29,29,29,29},
{29,29,29,29,29,29,29,29,29,40,0,0,0,0,0,0,0,0,0,0,0,0,0,0,0,0,0,5,0,0,0,0,0,10,29,29,29,29,29,29,29,29,29,29,29},
{29,29,29,29,29,29,29,29,29,40,0,0,0,0,0,0,0,0,0,0,0,0,0,0,0,0,0,5,0,0,0,0,0,10,29,29,29,29,29,29,29,29,29,29,29},
{29,29,29,29,29,29,29,29,29,40,0,0,0,0,0,0,0,0,0,0,0,0,0,0,0,0,0,4,0,0,0,0,0,10,29,29,29,29,29,29,29,29,29,29,29},
{29,29,29,29,29,29,29,29,29,40,0,0,0,0,0,0,0,0,0,0,0,0,0,0,0,0,0,5,25,31,31,31,37,10,29,29,29,29,29,29,29,29,29,29,29},
{29,29,29,29,29,29,29,29,29,40,0,0,0,0,0,0,0,0,0,0,0,0,0,0,0,0,0,6,0,0,0,0,0,10,29,29,29,29,29,29,29,29,29,29,29},
{29,29,29,29,29,29,29,29,29,40,0,0,0,0,0,0,0,0,0,0,0,0,0,0,0,0,0,0,0,0,0,0,0,10,29,29,29,29,29,29,29,29,29,29,29},
{29,29,29,29,29,29,29,29,29,40,0,0,0,0,0,0,0,0,0,0,0,0,0,0,0,0,0,0,0,0,0,0,0,10,29,29,29,29,29,29,29,29,29,29,29},
{29,29,29,29,29,29,29,29,29,40,0,0,0,0,0,0,0,0,0,0,0,0,0,0,0,0,0,0,0,0,0,0,0,10,29,29,29,29,29,29,29,29,29,29,29},
{29,29,29,29,29,29,29,29,29,40,0,0,0,0,0,0,0,0,0,0,0,0,0,0,0,0,0,0,0,0,0,0,0,10,29,29,29,29,29,29,29,29,29,29,29},
{29,29,29,29,29,29,29,29,29,40,0,0,0,0,0,0,0,0,0,0,0,0,0,0,0,0,0,0,0,0,0,0,0,10,29,29,29,29,29,29,29,29,29,29,29},
{29,29,29,29,29,29,29,29,29,40,0,0,0,0,0,0,0,0,0,0,0,0,0,0,0,0,0,0,0,0,0,0,0,10,29,29,29,29,29,29,29,29,29,29,29},
{29,29,29,29,29,29,29,29,29,47,27,27,27,15,0,9,27,27,27,27,27,27,27,27,27,27,27,27,27,27,27,27,27,43,29,29,29,29,29,29,29,29,29,29,29},
{29,29,29,29,29,29,29,29,29,28,23,23,23,17,0,10,29,29,29,29,29,29,29,29,29,29,29,29,29,29,29,29,29,29,29,29,29,29,29,29,29,29,29,29,29},
{29,29,29,29,29,29,29,29,29,23,23,29,23,17,0,10,29,29,29,29,29,29,29,29,29,29,29,29,29,29,29,29,29,29,29,29,29,29,29,29,29,29,29,29,29},
{29,29,29,29,29,29,29,29,29,29,29,29,23,17,0,10,29,29,29,29,29,29,29,29,29,29,29,29,29,29,29,29,29,29,29,29,29,29,29,29,29,29,29,29,29},
{29,29,29,29,29,29,29,29,29,48,30,30,30,18,0,12,30,30,30,44,29,29,29,29,29,29,29,29,29,29,29,29,29,29,29,29,29,29,29,29,29,29,29,29,29},
{29,29,29,29,29,29,29,29,29,17,0,0,0,0,0,0,0,0,0,10,29,29,29,29,29,29,29,29,29,29,29,29,29,29,29,29,29,29,29,29,29,29,29,29,29},
{29,29,29,29,29,29,29,29,29,17,0,0,0,0,0,0,0,0,0,10,29,29,29,29,29,29,29,29,29,29,29,29,29,29,29,29,29,29,29,29,29,29,29,29,29},
{29,29,29,29,29,29,29,29,29,17,0,0,0,0,0,0,0,0,0,10,29,29,29,29,29,29,29,29,29,29,29,29,29,29,29,29,29,29,29,29,29,29,29,29,29},
{29,29,29,29,29,29,29,29,29,17,0,0,0,0,0,0,0,0,0,10,29,29,29,29,29,29,29,29,29,29,29,29,29,29,29,29,29,29,29,29,29,29,29,29,29},
{29,29,29,29,29,29,29,29,29,17,0,0,0,0,0,0,0,0,0,10,29,29,29,29,29,29,29,29,29,29,29,29,29,29,29,29,29,29,29,29,29,29,29,29,29},
{29,29,29,29,29,29,29,29,29,17,0,0,0,0,0,0,0,0,0,10,29,29,29,29,29,29,29,29,29,29,29,29,29,29,29,29,29,29,29,29,29,29,29,29,29},
{29,29,29,29,29,29,29,29,29,17,0,0,0,0,0,0,0,0,0,10,29,29,29,29,29,29,29,29,29,29,29,29,29,29,29,29,29,29,29,29,29,29,29,29,29},
{29,29,29,29,29,29,29,29,29,17,0,0,0,0,0,0,0,0,0,10,29,29,29,29,29,29,29,29,29,29,29,29,29,29,29,29,29,29,29,29,29,29,29,29,29},
{29,29,29,29,29,29,29,29,29,17,0,0,0,0,0,0,0,0,0,10,29,29,29,29,29,29,29,29,29,29,29,29,29,29,29,29,29,29,29,29,29,29,29,29,29},
{29,29,29,29,29,29,29,29,29,17,0,0,0,0,0,0,0,0,0,10,29,29,29,29,29,29,29,29,29,29,29,29,29,29,29,29,29,29,29,29,29,29,29,29,29},
{29,29,29,29,29,29,29,29,29,47,27,27,27,27,27,27,27,27,27,43,29,29,29,29,29,29,29,29,29,29,29,29,29,29,29,29,29,29,29,29,29,29,29,29,29},
{29,29,29,29,29,29,29,29,29,29,29,29,29,29,29,29,29,29,29,29,29,29,29,29,29,29,29,29,29,29,29,29,29,29,29,29,29,29,29,29,29,29,29,29,29},
{29,29,29,29,29,29,29,29,29,29,29,29,29,29,29,1,1,29,29,29,29,29,29,29,29,29,29,29,29,29,29,29,29,29,29,29,29,29,29,29,29,29,29,29,29},
{29,29,29,29,29,29,29,29,29,29,29,29,1,1,1,1,29,29,29,29,29,29,29,29,29,29,29,29,29,29,29,29,29,29,29,29,29,29,29,29,29,29,29,29,29},
{29,29,29,29,29,29,29,29,29,29,29,29,29,29,29,29,29,29,29,29,29,29,29,29,29,29,29,29,29,29,29,29,29,29,29,29,29,29,29,29,29,29,29,29,29},
{29,29,29,29,29,29,29,29,29,29,29,29,29,29,29,29,29,29,29,29,29,29,29,29,29,29,29,29,29,29,29,29,29,29,29,29,29,29,29,29,29,29,29,29,29}
}
loadCollision{

